border_size=1
usage=map

       Hh,       Hh,    Gs^Fp,       Hh,    Gs^Fp,    Gs^Fp,    Gs^Fp,    Gs^Fp,    Gs^Fp,    Gs^Fp,       Gg,       Aa,       Aa,       Aa,       Aa,       Aa,       Ha,       Ha,       Mm,       Mm,       Mm,       Mm,       Mm,       Mm,       Hh,       Gg,    Gs^Fp,    Gs^Fp,       Gg,       Re,       Gg,    Gs^Fp,    Gs^Fp,       Gg,    Gs^Fp,       Hh,    Gs^Fp,    Gs^Fp,       Gg,       Ww,    Gs^Fp,    Gs^Fp
       Hh,       Hh,    Gs^Fp,       Hh,    Gs^Fp,    Gs^Fp,    Gs^Fp,    Gs^Fp,    Gs^Fp,    Gs^Fp,       Gg,       Aa,       Aa,       Aa,       Aa,       Aa,       Ha,       Ha,       Mm,       Mm,       Mm,       Mm,       Mm,       Mm,       Hh,       Gg,    Gs^Fp,    Gs^Fp,       Gg,       Re,       Gg,    Gs^Fp,    Gs^Fp,       Gg,    Gs^Fp,       Hh,    Gs^Fp,    Gs^Fp,       Gg,       Ww,    Gs^Fp,    Gs^Fp
       Ww,       Ww,       Hh,       Hh,       Hh,       Hh,       Hh,       Gg,       Gg,       Gg,       Gg,       Aa,       Aa,       Aa,       Aa,       Aa,       Gg,       Hh,       Hh,       Hh,       Hh,       Hh,       Mm,       Hh,   Hh^Vhh,       Gg,       Gg,    Gs^Fp,       Ch,       Ch,       Ch,       Gg,    Gs^Fp,    Gs^Fp,       Hh,       Hh,       Hh,       Ww,       Ww,       Ww,       Gg,       Gg
       Ww,       Ww,       Hh,       Hh,       Hh,       Hh,       Hh,       Hh,    Gs^Fp,       Ce,     3 Ke,       Ce,       Aa,       Aa,       Aa,       Aa,       Gg,       Hh,       Hh,       Hh,       Hh,       Hh,       Hh,       Hh,       Hh,       Gg,       Gg,    Gs^Fp,       Ch,     2 Kh,       Ch,       Gg,       Hh,   Hh^Vhh,       Hh,       Hh,       Ww,       Ww,       Ww,       Ww,       Ww,       Ww
       Ww,       Ww,       Hh,       Hh,       Mm,       Hh,       Hh,       Hh,       Hh,       Ce,       Gg,       Ce,       Re,       Aa,       Aa,   Aa^Fpa,       Gg,       Hh,       Hh,       Hh,       Hh,       Hh,       Hh,       Hh,       Hh,    Gs^Fp,    Gs^Fp,       Gg,       Re,       Ch,       Gg,    Gs^Fp,       Hh,       Hh,       Mm,       Mm,       Ww,       Ww,       Ww,       Ww,       Ww,       Ww
       Hh,       Hh,       Hh,       Mm,       Mm,       Hh,       Mm,       Hh,       Hh,       Gg,    Gs^Fp,       Gg,       Gg,       Re,       Hh,    Gs^Fp,    Gs^Fp,       Gg,       Hh,       Hh,       Gg,       Hh,       Hh,       Hh,    Gs^Fp,    Gs^Fp,       Re,       Re,       Gg,       Gg,    Gg^Ve,       Hh,       Hh,       Hh,       Mm,       Mm,       Ww,       Ww,       Ww,       Ai,       Ai,       Ai
   Hh,   Hh^Vhh,       Mm,       Mm,       Mm,       Mm,       Mm,       Hh,       Hh,       Gg,    Gg^Ve,       Hh,       Gg,       Re,       Hh,       Hh,    Gs^Fp,       Gg,       Hh,       Hh,       Gg,       Hh,       Hh,       Hh,       Re,       Re,       Hh,       Hh,    Gs^Fp,    Gs^Fp,       Hh,       Hh,       Hh,       Mm,       Mm,       Mm,       Ww,       Ww,       Ww,       Ai,       Ai,       Ai
       Mm,       Mm,       Mm,       Mm,       Mm,       Mm,       Hh,       Hh,       Hh,    Gs^Fp,    Gs^Fp,    Gs^Fp,    Gg^Vh,       Re,       Re,       Hh,       Re,       Hh,    Gg^Vh,       Gg,       Hh,    Gs^Fp,       Gg,       Gg,       Aa,    Gg^Vh,       Gg,       Hh,       Gg,       Hh,       Hh,       Hh,       Hh,       Mm,       Mm,       Mm,       Mm,       Mm,       Mm,       Ww,       Hh,       Hh
       Mm,       Mm,       Mm,       Mm,       Mm,       Hh,       Hh,       Hh,       Hh,    Gs^Fp,       Hh,       Hh,       Re,       Re,       Gg,       Re,       Hh,       Re,       Re,       Gg,       Hh,    Gs^Fp,       Aa,       Aa,       Aa,       Aa,       Ha,       Hh,       Hh,       Hh,       Mm,       Mm,       Mm,       Mm,       Mm,       Hh,       Mm,       Mm,       Mm,       Hh,       Hh,       Hh
       Mm,       Mm,       Mm,       Mm,       Mm,       Hh,       Hh,       Hh,       Re,       Gg,       Re,       Re,       Gg,       Gg,       Hh,       Hh,       Hh,       Gg,       Hh,       Re,       Re,   Aa^Fpa,       Aa,       Aa,       Aa,       Ha,       Ha,       Hh,       Hh,       Mm,       Mm,       Mm,       Mm,       Mm,       Mm,       Mm,       Hh,       Mm,       Hh,       Hh,       Hh,       Hh
       Mm,       Mm,       Mm,       Mm,       Mm,       Mm,       Hh,       Ha,       Aa,       Re,       Aa,       Aa,       Ha,       Hh,       Hh,       Hh,       Hh,       Hh,       Hh,       Gg,    Gs^Fp,       Aa,       Aa,       Aa,       Aa,       Aa,       Re,       Hh,       Hh,       Hh,       Hh,       Mm,       Mm,       Mm,       Mm,       Mm,       Mm,       Mm,       Hh,       Hh,       Hh,       Hh
       Mm,       Mm,       Mm,       Mm,       Re,       Ha,       Ha,       Ha,       Aa,       Aa,       Aa,       Ha,       Ha,       Ha,       Hh,       Hh,       Hh,       Hh,   Hh^Vhh,       Gg,       Gg,   Aa^Fpa,       Aa,       Aa,       Aa,       Ha,       Gg,       Re,       Re,       Hh,       Hh,       Hh,       Hh,       Mm,       Hh,       Mm,       Mm,       Mm,       Hh,       Hh,       Hh,       Hh
       Re,       Re,       Re,       Re,   Mm^Vhh,       Re,       Re,       Aa,       Re,       Aa,       Aa,       Ha,       Ha,       Ha,       Hh,       Hh,       Hh,       Hh,    Gs^Fp,       Gg,    Gs^Fp,       Hh,       Aa,       Aa,       Aa,       Ha,       Hh,       Gg,       Hh,       Re,       Re,       Hh,       Hh,       Hh,       Ha,       Ha,       Ha,       Hh,   Aa^Vea,       Hh,    Gs^Fp,    Gs^Fp
       Mm,       Mm,       Mm,       Mm,       Mm,       Hh,    Gg^Vh,       Re,       Hh,       Ha,       Aa,       Aa,       Aa,       Aa,       Gg,       Hh,    Gs^Fp,    Gs^Fp,       Gg,    Gs^Fp,    Gs^Fp,       Hh,       Ha,       Ha,       Ha,       Ha,       Hh,       Hh,       Hh,       Hh,       Gg,       Re,       Re,       Re,       Gg,       Ha,       Ha,       Ha,       Aa,    Gs^Fp,    Gs^Fp,    Gs^Fp
       Mm,       Mm,       Mm,       Mm,       Hh,       Hh,    Gs^Fp,       Re,       Gg,       Gg,       Gg,       Aa,       Gg,       Gg,    Gs^Fp,    Gs^Fp,    Gs^Fp,    Gs^Fp,       Gg,       Gg,       Hh,       Hh,       Hh,       Ha,       Hh,   Hh^Vhh,       Mm,       Hh,       Hh,       Hh,       Hh,       Gg,       Re,    Gg^Vh,       Gg,       Gg,       Gg,       Ha,       Aa,    Gs^Fp,    Gg^Ve,    Gg
       Mm,       Mm,       Mm,       Mm,       Hh,       Hh,       Re,       Re,       Gg,       Gg,       Hh,       Gg,       Gg,    Gs^Fp,    Gg^Ve,    Gs^Fp,    Gs^Fp,    Gs^Fp,       Gg,       Hh,       Hh,       Gg,       Hh,       Hh,       Hh,       Mm,       Mm,       Mm,       Mm,       Hh,       Hh,       Hh,       Re,       Gg,       Hh,       Gg,       Gg,       Aa,       Gg,    Gs^Fp,       Re,       Re
       Mm,       Mm,       Mm,       Mm,       Re,       Re,       Hh,       Hh,       Gg,       Hh,       Hh,       Hh,       Hh,    Gs^Fp,    Gs^Fp,    Gs^Fp,    Gs^Fp,    Gs^Fp,       Hh,       Hh,       Hh,       Gg,       Hh,       Hh,       Mm,       Mm,       Mm,       Mm,       Mm,       Mm,       Hh,       Hh,       Re,       Hh,       Hh,       Hh,       Gg,       Gg,    Gs^Fp,       Gg,       Re,       Re
       Mm,       Mm,       Mm,       Mm,       Re,       Hh,       Hh,       Hh,       Hh,       Hh,       Hh,       Hh,    Gs^Fp,    Gs^Fp,    Gg^Ve,    Gs^Fp,       Gg,       Gg,       Hh,       Hh,       Gg,       Hh,       Mm,       Mm,       Mm,       Mm,       Mm,       Mm,       Hh,       Hh,       Hh,       Gg,       Gg,       Re,       Hh,    Gs^Fp,       Hh,    Gs^Fp,    Gs^Fp,       Re,       Gg,       Gg
       Mm,       Mm,       Mm,       Re,       Hh,       Hh,       Mm,       Mm,       Mm,       Mm,       Hh,       Hh,       Hh,       Hh,       Hh,       Gg,       Gg,       Gg,       Hh,       Gg,       Hh,       Hh,       Ww,       Mm,       Mm,       Mm,       Mm,       Mm,       Mm,       Hh,       Hh,       Hh,       Hh,       Re,       Hh,    Gs^Fp,       Hh,    Gs^Fp,    Gs^Fp,    Gs^Fp,       Gg,       Gg
       Ww,       Ww,       Mm,       Re,       Hh,       Hh,       Mm,       Mm,       Mm,       Mm,       Mm,       Mm,       Mm,       Hh,       Ha,       Aa,       Aa,       Gg,       Gg,       Gg,       Hh,       Ww,       Ww,       Ww,   Mm^Vhh,       Mm,       Mm,       Mm,       Hh,       Hh,       Hh,       Hh,       Hh,       Re,       Re,       Re,       Hh,       Hh,       Hh,    Gs^Fp,       Gg,       Gg
       Ww,       Ww,       Re,       Re,       Hh,       Mm,       Mm,       Mm,       Mm,       Mm,       Mm,       Mm,       Mm,       Hh,       Hh,       Ha,       Aa,       Gg,       Aa,       Aa,       Ai,       Ww,       Ww,       Ww,       Ww,       Mm,       Mm,       Mm,       Hh,       Hh,       Hh,       Hh,       Gg,       Gg,       Re,       Gg,       Gg,    Gs^Fp,    Gs^Fp,    Gs^Fp,    Gs^Fp,    Gs^Fp
       Hh,       Hh,       Re,       Hh,       Hh,       Mm,       Mm,       Mm,       Mm,       Mm,       Mm,       Mm,       Hh,       Hh,       Hh,       Ha,       Ha,       Aa,       Aa,       Ai,    Ww^Vm,       Ww,       Ww,       Ww,       Ww,       Mm,       Mm,       Mm,       Mm,       Hh,       Hh,       Gg,       Ce,       Gg,       Re,       Gg,       Gg,    Gs^Fp,    Gs^Fp,       Hh,       Hh,       Hh
       Re,       Re,       Gg,       Gg,       Hh,       Hh,       Hh,       Mm,       Mm,       Mm,       Hh,       Hh,       Hh,       Hh,       Hh,       Gg,       Gg,       Gg,       Gg,       Ai,       Ww,       Ww,       Ww,       Ww,       Ww,       Mm,       Mm,       Mm,       Mm,       Hh,       Hh,       Ce,     1 Ke,       Ce,   Hh^Vhh,       Hh,       Hh,       Hh,       Hh,       Hh,   Mm^Vhh,   Mm
       Re,       Re,       Hh,       Hh,       Gg,       Hh,       Hh,       Hh,       Hh,       Hh,   Hh^Vhh,       Hh,       Hh,       Hh,       Gg,       Hh,       Hh,       Gg,       Hh,       Gg,       Hh,       Ww,       Hh,       Mm,       Mm,       Mm,       Mm,       Mm,       Mm,       Hh,       Re,       Ce,       Ce,       Ce,       Hh,       Mm,       Hh,       Hh,       Mm,       Mm,       Mm,       Mm
       Re,       Re,       Re,       Hh,       Gg,       Hh,       Hh,       Hh,       Hh,       Hh,       Hh,       Gg,       Hh,       Hh,       Hh,       Hh,       Hh,       Gg,       Hh,       Hh,       Hh,       Hh,       Hh,       Mm,       Mm,       Mm,       Mm,       Mm,       Hh,       Hh,       Hh,       Re,       Gg,       Gg,       Mm,       Mm,       Mm,       Mm,       Mm,       Mm,       Mm,       Mm
       Aa,       Aa,       Aa,       Re,       Aa,    Gs^Fp,    Gs^Fp,       Gg,       Gg,       Hh,       Hh,       Gg,       Gg,       Gg,       Gg,       Gg,       Gg,       Gg,       Hh,       Hh,       Hh,       Hh,       Hh,       Mm,       Mm,       Hh,       Hh,       Hh,       Hh,       Hh,       Hh,       Re,       Hh,       Gg,       Mm,       Mm,       Mm,       Mm,       Mm,       Mm,       Mm,       Mm
       Aa,       Aa,       Aa,       Aa,       Gg,       Gg,       Gg,       Gg,       Gg,       Hh,       Ww,       Ww,       Ww,       Ww,       Ww,       Ww,       Gg,       Gg,       Gg,       Hh,       Hh,       Hh,       Hh,       Hh,       Hh,       Hh,       Gg,       Gg,       Gg,       Gg,       Gg,       Re,       Gg,       Gg,       Hh,       Mm,       Mm,       Mm,       Mm,       Mm,       Mm,       Mm
       Aa,       Aa,       Aa,       Aa,       Gg,     4 Kh,       Gg,       Gg,       Gg,       Hh,       Ww,       Ww,       Ww,       Ww,       Gg,       Gg,       Mm,       Mm,       Hh,       Hh,       Hh,       Hh,       Gg,       Gg,       Gg,       Hh,       Gg,       Gg,   Hh^Vhh,       Gg,       Ww,       Re,       Re,       Hh,       Hh,       Mm,       Mm,       Mm,       Mm,       Mm,       Mm,       Mm
       Aa,       Aa,       Aa,   Aa^Fpa,       Aa,       Gg,       Gg,       Gg,       Hh,       Hh,       Ww,       Ww,       Ww,       Gg,   Mm^Vhh,       Mm,       Mm,       Mm,       Mm,   Hh^Vhh,       Hh,       Gg,       Hh,       Gg,       Hh,       Gg,       Hh,       Ww,       Ww,       Ww,       Ww,       Gg,       Re,   Mm^Vhh,       Mm,       Mm,       Mm,       Mm,       Mm,       Mm,       Mm,       Mm
       Gg,       Gg,    Gs^Fp,    Gg^Ve,    Gs^Fp,       Gg,       Gg,       Gg,       Gg,       Ww,       Ww,       Ww,       Ww,       Gg,       Gg,       Gg,       Mm,       Mm,       Mm,       Mm,       Hh,       Gg,       Hh,       Hh,       Hh,       Hh,       Hh,       Ww,       Ww,       Ww,       Ww,       Gg,       Re,       Hh,       Ai,       Mm,       Mm,       Mm,       Mm,       Mm,       Mm,       Mm
    Gs^Fp,    Gs^Fp,    Gs^Fp,    Gs^Fp,       Gg,       Gg,       Gg,       Hh,       Hh,       Hh,       Gg,       Ww,       Ww,       Ww,       Ww,       Ww,       Gg,       Gg,       Mm,       Mm,       Hh,       Gg,       Hh,       Hh,       Ha,       Mm,       Mm,       Hh,       Ww,       Ww,       Ww,       Gg,       Hh,       Re,       Re,       Mm,       Hh,       Hh,       Hh,       Mm,       Mm,       Mm
    Gs^Fp,    Gs^Fp,    Gs^Fp,    Gs^Fp,       Gg,       Gg,       Gg,       Hh,       Hh,       Hh,       Gg,       Ww,       Ww,       Ww,       Ww,       Ww,       Gg,       Gg,       Mm,       Mm,       Hh,       Gg,       Hh,       Hh,       Ha,       Mm,       Mm,       Hh,       Ww,       Ww,       Ww,       Gg,       Hh,       Re,       Re,       Mm,       Hh,       Hh,       Hh,       Mm,       Mm,       Mm
