border_size=1
usage=map

Hh          , Hh          , Hh          , Hh          , Hh          , Hh          , Mm          , Mm          , Mm          , Mm          , Mm          , Mm          , Mm          , Mm          , Hh          , Hh          , Gg          , Gg          , Ds          , Ww          , Ww          , Gg          , Gg          , Gg          
Hh          , Hh          , Hh          , Hh          , Hh          , Hh          , Mm          , Mm          , Mm          , Mm          , Mm          , Mm          , Mm          , Mm          , Hh          , Hh          , Gg          , Gg          , Ds          , Ww          , Ww          , Gg          , Gg          , Gg          
Hh          , Hh          , Hh          , Hh          , Hh          , Hh          , Hh          , Mm          , Mm          , Mm          , Mm          , Mm          , Mm          , Hh          , Hh          , Gg          , Gg          , Gg          , Gg          , Ds          , Ww          , Gg          , Gg          , Gg          
Hh          , Hh          , Hh          , Hh          , Hh          , Hh          , Hh          , Gg          , Ggf         , Gg          , Gg          , Mm          , Hh          , Hh          , Hh          , Hh          , Gg          , Gg          , Gg          , Gg          , Ww          , Gg          , Re          , Re          
Gg          , Gg          , Gg          , Hh          , Ss          , Hh          , Gg          , Gg          , Gg          , Gg          , Gg          , Hh          , Ww          , Ww          , Ww          , Gg          , Ww          , Gg          , Gg          , Ww          , Re          , Re          , Gg          , Gg          
Gg          , Gg          , Gg          , Hh          , Ss          , Ds          , Ds          , Gg          , Gg          , Gg          , Ww          , Ww          , Ce          , Gg          , Ce          , Ww          , Gg          , Ww          , Ww          , Ww          , Re          , Gg^Ve       , Gs^Fp       , Gs^Fp       
Gg          , Gg          , Gg          , Ds          , Ww          , Ww          , Ds          , Gg          , Gg          , Ww          , Hh          , Hh          , Ce          , 3 Ke        , Ce          , Gg          , Re          , Re          , Re          , Re          , Gs^Fp       , Gs^Fp       , Ss          , Ss          
Gg          , Gg          , Gg          , Gg          , Gg          , Gg          , Ggf         , Gg          , Gg          , Ww          , Ds          , Ds          , Gg          , Gg          , Re          , Re          , Gg          , Gs^Fp       , Gg          , Gs^Fp       , Gg          , Gg          , Gg          , Gg          
Gg          , Gg          , Gg          , Gg          , Gg          , Gg          , Gg          , Gg          , Gg          , Ww          , Ds          , Gg          , Gg          , Re          , Gg          , Gg          , Gg          , Gg          , Gg          , Gg          , Gg          , Gg          , Gg          , Gg          
Re          , Re          , Re          , Re          , Re          , Re          , Re          , Gg          , Gg          , Ww          , Ds          , Gg          , Gg          , Re          , Gg          , Gg          , Gg^Vh       , Gg          , Ggf         , Ggf         , Gg          , Gg          , Gg          , Gg          
Gg          , Gg          , Gg          , Gg          , Gg          , Gg          , Gs^Fp       , Re          , Re          , Ww          , Wwf         , Ds          , Re          , Re          , Gg          , Gg          , Gg          , Gg          , Gg          , Gg          , Gg          , Gg          , Gg          , Gg          
Gg          , Gg          , Gg          , Gs^Fp       , Gs^Fp       , Gg          , Gs^Fp       , Gs^Fp       , Gs^Fp       , Re          , Wwf         , Re          , Re          , Gs^Fp       , Gs^Fp       , Gg          , Gg          , Gg          , Gg          , Gg          , Gg^Vh       , Gg          , Ggf         , Gg          
Gs^Fp       , Gs^Fp       , Gs^Fp       , Gs^Fp       , Gs^Fp       , Gg          , Gs^Fp       , Gs^Fp       , Gs^Fp       , Gs^Fp       , Ss          , Gg^Ve       , Re          , Gs^Fp       , Gs^Fp       , Gs^Fp       , Gs^Fp       , Gg          , Gg          , Gg          , Gg          , Gg          , Gg          , Gg          
Gs^Fp       , Gs^Fp       , Gs^Fp       , Gs^Fp       , Gs^Fp       , Gg          , Gs^Fp       , Gs^Fp       , Gs^Fp       , Gs^Fp       , Ss          , Ss          , Gg          , Re          , Re          , Gs^Fp       , Gs^Fp       , Gs^Fp       , Gg          , Gg          , Gg          , Gg          , Ss          , Ss          
Gs^Fp       , Gs^Fp       , Gg^Ve       , Gs^Fp       , Gg          , Gg          , Ss          , Gs^Fp       , Ss          , Ss          , Ss          , Ss          , Ce          , Gg          , Re          , Gs^Fp       , Gs^Fp       , Gs^Fp       , Gs^Fp       , Gg          , Gg          , Gg          , Ss          , Ss          
Gs^Fp       , Gs^Fp       , Gs^Fp       , Gg          , Gs^Fp       , Gs^Fp       , Gs^Fp       , Ss          , Ss          , Ss          , Gs^Fp       , Gs^Fp       , Gs^Fp       , Gs^Fp       , Gs^Fp       , Re          , Gs^Fp       , Gs^Fp       , Gs^Fp       , Ss          , Ss          , Ss          , Ss          , Ss          
Gg          , Gg          , Gg          , Gg          , Gs^Fp       , Gs^Fp       , Ss          , Ss          , Ce          , Gs^Fp       , Gs^Fp       , Gs^Fp       , Gg          , Gs^Fp       , Gs^Fp       , Re          , Re          , Gg          , Gs^Fp       , Ss          , Ss          , Gs^Fp       , Ss          , Ss          
Gg          , Gg          , Gg          , Gg          , Gs^Fp       , Gs^Fp       , Gs^Fp       , Ww          , Ww          , Gs^Fp       , Gs^Fp       , Gg          , Gg          , Gg          , Gs^Fp       , Gg^Vh       , Re          , Gg          , Gs^Fp       , Ce          , Gg          , Gs^Fp       , Ss          , Ss          
Gg          , Gg          , Gg          , Gg          , Gg          , Gg          , Ww          , Ds          , Ww          , Gs^Fp       , Gs^Fp       , Gg^Ve       , Ggf         , Gg          , Gs^Fp       , Gs^Fp       , Re          , Gs^Fp       , Gs^Fp       , Gs^Fp       , Gs^Fp       , Gs^Fp       , Ss          , Ss          
Gg          , Gg          , Gg          , Gg          , Ww          , Ww          , Gg          , Ww          , Gs^Fp       , Gs^Fp       , Gs^Fp       , Ce          , 2 Ke        , Ce          , Gs^Fp       , Gs^Fp       , Re          , Gs^Fp       , Gg^Ve       , Gs^Fp       , Gs^Fp       , Gs^Fp       , Ss          , Ss          
Gg          , Gg          , Gg          , Gg          , Ww          , Gs^Fp       , Gs^Fp       , Gs^Fp       , Gs^Fp       , Gg          , Gs^Fp       , Ce          , Gg          , Ce          , Gs^Fp       , Gs^Fp       , Re          , Gs^Fp       , Gs^Fp       , Gs^Fp       , Gs^Fp       , Gs^Fp       , Gs^Fp       , Gs^Fp       
Gg          , Gg          , Ww          , Ww          , Gs^Fp       , Gs^Fp       , Gs^Fp       , Gs^Fp       , Gs^Fp       , Gs^Fp       , Gs^Fp       , Gs^Fp       , Gs^Fp       , Gs^Fp       , Gs^Fp       , Gg^Vh       , Re          , Gg          , Gg          , Ce          , Ss          , Gs^Fp       , Gs^Fp       , Gs^Fp       
Gg          , Gg          , Ww          , Gg^Ve       , Gg          , Gs^Fp       , Gs^Fp       , Ss          , Ce          , Gs^Fp       , Gs^Fp       , Gs^Fp       , Gs^Fp       , Gg          , Gg          , Re          , Gg          , Gs^Fp       , Gs^Fp       , Gg          , Gg          , Gg          , Gg          , Gg          
Gg          , Gg          , Ds          , Ww          , Ww          , Gg          , Gs^Fp       , Gg          , Gg          , Gs^Fp       , Gs^Fp       , Gs^Fp       , Gs^Fp       , Gs^Fp       , Gs^Fp       , Re          , Gg          , Gs^Fp       , Gs^Fp       , Gs^Fp       , Gg          , Gg          , Gs^Fp       , Gs^Fp       
Gs^Fp       , Gs^Fp       , Ds          , Ww          , Ww          , Gg          , Gg          , Gg          , Ggf         , Gg          , Gg          , Gs^Fp       , Gg          , Ce          , Gs^Fp       , Re          , Gs^Fp       , Gs^Fp       , Gs^Fp       , Gs^Fp       , Gg          , Gg^Vh       , Gs^Fp       , Gs^Fp       
Gs^Fp       , Gs^Fp       , Ds          , Ww          , Gg          , Gg          , Ww          , Gg          , Hh          , Hh          , Hh          , Gg          , Gs^Fp       , Gg          , Gs^Fp       , Re          , Gs^Fp       , Gs^Fp       , Gs^Fp       , Gs^Fp       , Gs^Fp       , Gs^Fp       , Gs^Fp       , Gs^Fp       
Gs^Fp       , Gs^Fp       , Gg          , Ww          , Ww          , Ww          , Ww          , Ww          , Hh^Vhh      , Mm          , Mm          , Mm          , Hh          , Hh          , Re          , Re          , Gg          , Gg          , Gs^Fp       , Gs^Fp       , Gs^Fp       , Gs^Fp       , Gs^Fp       , Gs^Fp       
Gs^Fp       , Gs^Fp       , Gs^Fp       , Ds          , Gs^Fp       , Gg          , Ds          , Ww          , Ww          , Ww          , Mm          , Mm          , Hh          , Gg          , Re          , Gg          , Gs^Fp       , Gs^Fp       , Gs^Fp       , Gs^Fp       , Gs^Fp       , Gs^Fp       , Wo          , Wo          
Gs^Fp       , Gs^Fp       , Gs^Fp       , Gs^Fp       , Gs^Fp       , Gs^Fp       , Gs^Fp       , Ds          , Ww          , Mm          , Mm          , Mm          , Hh          , Hh          , Re          , Gs^Fp       , Gs^Fp       , Gs^Fp       , Gs^Fp       , Gs^Fp       , Gs^Fp       , Gs^Fp       , Wo          , Wo          
Gs^Fp       , Gs^Fp       , Gs^Fp       , Gs^Fp       , Gg          , Gg          , Gg          , Ds          , Ww          , Ww          , Mm          , Mm          , Hh          , Gs^Fp       , Re          , Re          , Gs^Fp       , Gs^Fp       , Gs^Fp       , Gg          , Gs^Fp       , Gs^Fp       , Gs^Fp       , Gs^Fp       
Gg          , Gg          , Gg^Ve       , Gg          , Gg          , Gg          , Gg          , Ds          , Ww          , Mm          , Mm          , Mm          , Hh          , Re          , Gg^Vh       , Gs^Fp       , Gg          , Gg          , Gg          , Gs^Fp       , Gs^Fp       , Gs^Fp       , Gs^Fp       , Gs^Fp       
Gg          , Gg          , Gg          , Gg          , Ggf         , Gg          , Gg          , Ds          , Ds          , Ww          , Ww          , Hh          , Re          , Re          , Gg          , Gg          , Gs          , Gs          , Gg          , Gg          , Gg          , Gs^Fp       , Gs^Fp       , Gs^Fp       
Gg          , Gg          , Gg          , Ggf         , Gs          , Gg          , Gs          , Gg          , Gg          , Ds          , Ds          , Wwf         , Wwf         , Gg          , Gg          , Gg          , Gs          , Gs          , Gg          , Gg          , Gg          , Gs^Fp       , Gg^Ve       , Gg          
Gg          , Gg          , Gg          , Ggf         , Gs          , Gs          , Ggf         , Gg          , Gg          , Gg          , Ds          , Re          , Ww          , Gg          , Ss          , Gg          , Ggf         , Ggf         , Gg          , Gg          , Gg          , Gs^Fp       , Gs^Fp       , Gs^Fp       
Gg          , Gg          , Gg^Vh       , Gg          , Gg          , Gs          , Gg          , Gg          , Gs^Fp       , Gg^Vh       , Re          , Re          , Gg          , Ss          , Ss          , Gg          , Gg          , Gg          , Gg          , Gg          , Gg          , Gs^Fp       , Gs^Fp       , Gs^Fp       
Gg          , Gg          , Re          , Re          , Re          , Gg          , Gg          , Gg          , Re          , Re          , Re          , Gs^Fp       , Ss          , Ss          , Ss          , Ss          , Ss          , Ss          , Ss          , Gg          , Gg          , Gs^Fp       , Gs^Fp       , Gs^Fp       
Re          , Re          , Gs^Fp       , Gs^Fp       , Gg          , Re          , Re          , Re          , Gg          , Gg          , Re          , Gs^Fp       , Gg          , Ss          , Gs          , Ss          , Ss          , Ss          , Ss          , Gg          , Gg          , Gg          , Gg          , Gg          
Gg          , Gg          , Gg          , Gg          , Gg          , Gg          , Gg          , Ggf         , Ggf         , Gg          , Re          , Gg          , Gg          , Gg          , Gs          , Ss          , Ss          , Ss^Vhs      , Ww          , Gg          , Gg          , Ggf         , Gg          , Gg          
Gg          , Gg          , Ggf         , Gg          , Gg          , Gg          , Gg          , Gg          , Gg          , Gg          , Re          , Gg          , Gg          , Gg          , Gg          , Gs          , Gs          , 4 Kh        , Gg          , Ww          , Ww          , Gg          , Gg          , Gg          
Gg          , Gg          , Ggf         , Ggf         , Gg          , Gs^Fp       , Gg^Ve       , Gg          , Gg          , Gg          , Ce          , Gg          , Ce          , Gg          , Gg          , Gg          , Gg          , Gg          , Gg          , Gg          , Ww          , Gg          , Gg          , Gg          
Gg          , Gg          , Gg          , Gg          , Gg          , Gs^Fp       , Gs^Fp       , Gg          , Gg          , Gg          , Ce          , 1 Ke        , 5 Ke        , Gg          , Gg          , Gg^Wm       , Gg          , Gg          , Ww          , Ww          , Gg          , Gg          , Gg          , Gg          
Gg          , Gg          , Gg          , Gg          , Gg          , Gs^Fp       , Gs^Fp       , Gg          , Gg          , Gg          , Gg          , Gg          , Gg          , Gg          , Gg          , Gg          , Gg          , Gg          , Ww          , Ww          , Gg          , Gg          , Gg          , Gg          
