border_size=1
usage=map

Rr          , Uu          , Uu          , Uu          , Uu          , Uu          , Uu^Uf       , Uu          , Uu          , Xu          , Xu          , Xu          , Xu          , Xu          , Uu          , Xu          , Uu          , Xu          , Xu          , Xu          , Xu          , Xu          , Xu          , Xu          , Xu          , Xu          , Xu          , Xu          , Xu          , Xu          , Xu          , Xu          , Xu          , Xu          , Xu          , Uu          , Uu          , Uu          , Xu          , Xu          , Xu          , Xu          
Rr          , Uu          , Uu          , Uu          , Uu^Vu       , Uu          , Uu^Uf       , Uu          , Uu          , Xu          , Xu          , Xu          , Xu          , Xu          , Uu          , Xu          , Uu          , Xu          , Xu          , Xu          , Xu          , Xu          , Xu          , Xu          , Xu          , Xu          , Xu          , Xu          , Xu          , Xu          , Xu          , Xu          , Xu          , Xu          , Xu          , Uu          , Uu^Vu       , Uu          , Xu          , Xu          , Xu          , Xu          
Uu          , Rr          , Rr          , Uu          , Uu          , Uu          , Uu          , Uu          , Uu^Vud      , Uu          , Uu          , Uu          , Uu          , Uu          , Re          , Re          , Uu          , Uu          , Uu          , Xu          , Xu          , Xu          , Xu          , Xu          , Xu          , Xu          , Uu          , Uu          , Re          , Uu^Vu       , Uu          , Xu          , Cud         , Cud         , Uu          , Uu          , Uu          , Xu          , Xu          , Xu          , Xu          , Xu          
Uu          , Uu          , Uu          , Uu          , Uu          , Uu          , Uu          , Uu          , Uu          , Uu          , Uh          , Uu          , Re          , Re          , Uu          , Uu          , Uu          , Uu          , Uu          , Xu          , Uh          , Xu          , Xu          , Xu          , Ww          , Uu          , Uu          , Re          , Uu          , Re          , Uu          , Uu          , Uu          , 3 Kud       , Cud         , Uu          , Uu          , Uu          , Uu          , Xu          , Xu          , Xu          
Uu          , Uu          , Cud         , Cud         , Cud         , Uu          , Uu          , Uu          , Uu          , Uu          , Uu          , Uu          , Uu          , Uu          , Uu          , Xu          , Uu          , Uu          , Re          , Uu          , Uu          , Uu          , Uh          , Re          , Uu          , Ww          , Ww          , Uu          , Uu          , Xu          , Uu          , Uu          , Uu          , Cud         , Uu          , Uu          , Uu^Vud      , Uu          , Xu          , Xu          , Xu          , Xu          
Uu          , Uu          , Cud         , 5 Kud       , Cud         , Rr          , Rr          , Rr          , Uu          , Uh          , Uu          , Uu          , Uu          , Uu          , Uu          , Xu          , Xu          , Uu^Uf       , Re          , Re          , Uu          , Uu          , Uu          , Uh          , Uh          , Uu          , Uu          , Ww          , Xu          , Xu          , Uu^Vud      , Re          , Uu          , Uu          , Uu          , Uu          , Uu          , Uu          , Xu          , Xu          , Xu          , Xu          
Uu          , Uu          , Uu          , Cud         , Uu          , Uu          , Uu          , Xu          , Xu          , Rr          , Uu          , Uu          , Uu          , Uu          , Uu          , Uu          , Xu          , Re          , Uu          , Uu          , Uu^Vud      , Uu          , Xu          , Uu          , Xu          , Uh          , Xu          , Xu          , Uu          , Xu          , Uu          , Uu          , Xu          , Xu          , Xu          , Uu^Vu       , Xu          , Xu          , Xu          , Xu          , Xu          , Xu          
Xu          , Xu          , Uu          , Uu          , Uu          , Uu^Uf       , Uu          , Xu          , Uu^Vu       , Uu          , Uu          , Uu          , Rr          , Uu          , Uu^Vud      , Uu          , Xu          , Uu          , Xu          , Xu          , Xu          , Xu          , Xu          , Uu          , Xu          , Xu          , Uu          , Uu          , Uh          , Uh          , Uu          , Re          , Uu          , Xu          , Xu          , Xu          , Xu          , Xu          , Xu          , Xu          , Xu          , Xu          
Xu          , Xu          , Uu^Vud      , Uu          , Uu          , Uu          , Uu          , Xu          , Uu          , Uu          , Re          , Ss          , Ss          , Rr          , Rr          , Xu          , Xu          , Xu          , Xu          , Xu          , Xu          , Xu          , Xu          , Xu          , Uh          , Uh          , Uu          , Uu          , Uu          , Uh          , Uu          , Ww          , Uu          , Xu          , Xu          , Xu          , Xu          , Xu          , Xu          , Xu          , Xu          , Xu          
Xu          , Xu          , Uu          , Uu          , Uu^Uf       , Uu^Uf       , Uu          , Uu          , Uu          , Re          , Uu          , Ss          , Ss          , Ss          , Rr          , Xu          , Xu          , Xu          , Xu          , Xu          , Xu          , Xu          , Xu          , Xu          , Uu          , Uu          , Uu^Vud      , Uu          , Re          , Uh          , Re          , Ww          , Uu^Vu       , Xu          , Xu          , Xu          , Xu          , Xu          , Xu          , Xu          , Xu          , Xu          
Xu          , Xu          , Xu          , Uu          , Xu          , Xu          , Uu          , Uu          , Uu          , Uu          , Uu          , Uu          , Uu          , Ss          , Uu          , Uu^Vu       , Uu          , Xu          , Xu          , Xu          , Xu          , Xu          , Uu          , Uu          , Uu          , Uu^Uf       , Uu          , Uu          , Xu          , Re          , Xu          , Ww          , Ww          , Ww          , Xu          , Xu          , Xu          , Xu          , Xu          , Xu          , Xu          , Xu          
Xu          , Xu          , Xu          , Xu          , Xu          , Xu          , Uu          , Uu          , Re          , Re          , Uu          , Uu          , Uu          , Uu          , Uu          , Uu          , Uu          , Rr          , Rr          , Xu          , Xu          , Xu          , Uu          , Uu          , Uu          , Uu          , Uu          , Xu          , Xu          , Xu          , Xu          , Ww          , Ww          , Ww          , Xu          , Xu          , Xu          , Xu          , Xu          , Xu          , Xu          , Xu          
Xu          , Xu          , Xu          , Xu          , Xu          , Xu          , Uu          , Uu          , Xu          , Xu          , Uu          , Uu          , Uu          , Uu          , Uu          , Uu          , Uu          , Uu          , Rr          , Uu          , Uu^Vud      , Uh          , Rr          , Rr          , Rr          , Uu          , Uu          , Xu          , Xu          , Xu          , Xu          , Xu          , Xu          , Xu          , Xu          , Xu          , Xu          , Xu          , Xu          , Xu          , 6 Kh        , Ch          
Xu          , Xu          , Uu          , Re          , Re          , Uu          , Uu          , Uu          , Xu          , Uu          , Uu          , Uu          , Xu          , Xu          , Uh          , Uu          , Uu          , Uu          , Uu          , Uu          , Rr          , Uu          , Uu          , Uu          , Uu          , Uu          , Uu          , Uu          , Uu          , Uu          , Xu          , Xu          , Xu          , Xu          , Xu          , Xu          , Xu          , Xu          , Xu          , Xu          , Xu          , Xu          
Xu          , Xu          , Xu          , Uu          , Uu          , Uu          , Uu          , Uu          , Xu          , Uu          , Uu          , Ww          , Ww          , Xu          , Uh          , Uh          , Cud         , Cud         , Cud         , Uu^Uf       , Xu          , Uu          , Uu          , Uu          , Uu          , Xu          , Uu          , Rr          , Rr          , Uu^Uf       , Uu^Uf       , Uu          , Uu          , Xu          , Xu          , Xu          , Xu          , Xu          , Xu          , Xu          , Xu          , Xu          
Xu          , Xu          , Xu          , Xu          , Uu          , Uu          , Re          , Re          , Uu          , Uu          , Uu          , Ww          , Ww          , Xu          , Xu          , Uh          , Cud         , 2 Kud       , Cud         , Uu          , Uu          , Xu          , Re          , Uu          , Xu          , Xu          , Uh          , Uh          , Rr          , Uu          , Uu          , Uu          , Cud         , Xu          , Xu          , Xu          , Xu          , Xu          , Xu          , Xu          , Xu          , Xu          
Xu          , Xu          , Xu          , Uu          , Uu          , Uh          , Uu          , Uu          , Uu          , Uu^Vu       , Ss          , Uu          , Uu          , Uu          , Uu          , Xu          , Xu          , Cud         , Uu          , Uu          , Uu          , Re          , Uu          , Uu          , Xu          , Xu          , Xu          , Uh          , Uu^Vu       , Rr          , Uu          , Cud         , Kud         , Xu          , Xu          , Xu          , Xu          , Xu          , Xu          , Xu          , Xu          , Xu          
Xu          , Xu          , Uu          , Uu          , Uu          , Uh          , Re          , Uu          , Uu          , Ss          , Ss          , Ss          , Uu          , Uu          , Uu          , Xu          , Xu          , Uh          , Uu          , Uu          , Uu          , Uu          , Xu          , Xu          , Xu          , Xu          , Xu          , Xu          , Uu          , Uu          , Uu          , Cud         , Cud         , Xu          , Xu          , Xu          , Xu          , Xu          , Xu          , Xu          , Xu          , Xu          
Xu          , Xu          , Uu          , Uu          , Uu          , Re          , Xu          , Uu          , Uu          , Uu          , Ss          , Ss          , Xu          , Xu          , Xu          , Xu          , Uu          , Uu          , Re          , Uu          , Uu          , Xu          , Xu          , Xu          , Xu          , Xu          , Xu          , Xu          , Xu          , Xu          , Uu          , Uu          , Rr          , Uu          , Ww          , Uu          , Uu          , Xu          , Xu          , Xu          , Xu          , Xu          
Xu          , Xu          , Uu          , Re          , Xu          , Xu          , Xu          , Xu          , Uu          , Uu          , Uu          , Xu          , Uu          , Uh          , Uh          , Uu          , Re          , Uu          , Re          , Uu          , Uu^Vu       , Xu          , Xu          , Xu          , Xu          , Xu          , Xu          , Xu          , Xu          , Uu          , Re          , Uu          , Rr          , Uu^Vud      , Ww          , Uu          , Uu^Uf       , Uu          , Xu          , Xu          , Xu          , Xu          
Xu          , Xu          , Uu          , Re          , Uu^Vud      , Xu          , Xu          , Xu          , Xu          , Uu          , Uu          , Uu          , Uu          , Uu          , Uu^Vud      , Uu          , Re          , Uu          , Uu          , Uu          , Uu          , Xu          , Uu          , Xu          , Xu          , Xu          , Xu          , Xu          , Uu          , Uu          , Re          , Xu          , Xu          , Uu          , Wwf         , Rr          , Rr          , Uu^Uf       , Xu          , Xu          , Xu          , Xu          
Xu          , Xu          , Uu          , Re          , Uu^Uf       , Xu          , Xu          , Xu          , Xu          , Re          , Re          , Uu          , Re          , Uu          , Uu          , Uu          , Uu          , Uu          , Uu          , Uu          , Uu          , Uu          , Uu          , Uu          , Uh          , Xu          , Xu          , Xu          , Uu          , Uu          , Re          , Xu          , Xu          , Xu          , Xu          , Ww          , Uu          , Uu          , Uh          , Xu          , Xu          , Xu          
Xu          , Xu          , Uu          , Uu          , Uu          , Xu          , Xu          , Xu          , Uu          , Uu          , Re          , Uu          , Uu          , Uu          , Re          , Uu          , Xu          , Xu          , Xu          , Uu          , Xu          , Uu          , Uu          , Uu          , Uh          , Xu          , Xu          , Xu          , Uh          , Uu          , Uu          , Xu          , Xu          , Xu          , Xu          , Ww          , Ww          , Wwf         , Uu          , Uu          , Xu          , Xu          
Xu          , Xu          , Uu          , Re          , Re          , Uu          , Uu          , Xu          , Uu          , Uu          , Uu          , Uu^Vu       , Uu          , Uu          , Uu          , Re          , Xu          , Xu          , Xu          , Xu          , Xu          , Re          , Ww          , Ww          , Uh          , Xu          , Xu          , Xu          , Uu^Vu       , Uu^Uf       , Uu          , Xu          , Xu          , Xu          , Xu          , Xu          , Ww          , Rr          , Uu          , Re          , Xu          , Xu          
Xu          , Xu          , Xu          , Uu          , Uu          , Uu          , Uu          , Uu          , Re          , Re          , Uu          , Uu          , Ww          , Ww          , Uu          , Re          , Uu          , Xu          , Xu          , Xu          , Ww          , Re          , Ww          , Ww          , Uu          , Xu          , Uu          , Uu          , Uu          , Uh          , Uu^Uf       , Xu          , Xu          , Xu          , Xu          , Xu          , Uu^Vu       , Ww          , Ww          , Xu          , Xu          , Xu          
Xu          , Xu          , Xu          , Uu          , Uu          , Uu^Vu       , Uu          , Re          , Uu          , Uu          , Uu^Uf       , Uu          , Ww          , Ww          , Ww          , Uu          , Uu          , Xu          , Xu          , Xu          , Ww          , Re          , Uu          , Uu          , Uu          , Uu          , Uu          , Uu          , Uu          , Uu          , Ss          , Ss          , Xu          , Xu          , Xu          , Xu          , Uu          , Rr          , Uu          , Xu          , Xu          , Xu          
Xu          , Xu          , Xu          , Uh          , Uu          , Re          , Cud         , Re          , Uu          , Uu^Uf       , Uu          , Xu          , Xu          , Ww          , Ww          , Uu          , Uu          , Uu          , Xu          , Xu          , Uu          , Uu          , Uu          , Uu          , Re          , Re          , Uu          , Re          , Re          , Uu          , Ss          , Ss          , Ss          , Xu          , Xu          , Xu          , Uu          , Uu          , Uu          , Xu          , Uu          , Uu          
Xu          , Xu          , Xu          , Uu          , Uu          , Cud         , 4 Kud       , Uu          , Uu          , Uu          , Xu          , Xu          , Xu          , Ww          , Xu          , Uu          , Uu          , Uu          , Ss          , Ss          , Ss          , Ss          , Uu          , Uu          , Xu          , Uu          , Uu          , Xu          , Uu          , Re          , Xu          , Ss          , Xu          , Xu          , Xu          , Xu          , Uu          , 1 Uu        , Rr          , Uu          , Uu          , Uu          
Xu          , Xu          , Uu^Vu       , Uu          , Uu          , Uu          , Cud         , Cud         , Uu          , Xu          , Xu          , Xu          , Xu          , Xu          , Xu          , Re          , Re          , Uu^Vu       , Ss          , Ss          , Ss          , Uu          , Uu          , Uu          , Xu          , Xu          , Xu          , Xu          , Uu          , Uu^Vud      , Xu          , Xu          , Xu          , Xu          , Xu          , Xu          , Uu          , Uu          , Rr          , Uu          , Uu          , Uu          
Xu          , Xu          , Xu          , Xu          , Xu          , Uu          , Uu          , Uu          , Uu          , Uu          , Xu          , Xu          , Xu          , Xu          , Xu          , Uu          , Uu          , Uu          , Uu          , Uu^Uf       , Uu          , Uu^Uf       , Uu          , Uu          , Xu          , Xu          , Xu          , Xu          , Xu          , Xu          , Xu          , Xu          , Xu          , Xu          , Xu          , Xu          , Uu          , Uu          , Uu          , Rr          , Uu          , Uu          
Xu          , Xu          , Xu          , Xu          , Xu          , Uu          , Uu          , Uu^Vud      , Uu          , Uu^Vud      , Xu          , Xu          , Xu          , Xu          , Xu          , Xu          , Xu          , Xu          , Xu          , Uu^Vud      , Xu          , Uu          , Xu          , Xu          , Xu          , Xu          , Xu          , Xu          , Xu          , Xu          , Xu          , Xu          , Xu          , Xu          , Xu          , Uu          , Uu          , Uu          , Uu          , Uu          , Rr          , Uu          
Xu          , Xu          , Xu          , Xu          , Xu          , Xu          , Xu          , Uu          , Uu          , Uu          , Xu          , Xu          , Xu          , Xu          , Xu          , Xu          , Xu          , Xu          , Xu          , Uu          , Xu          , Uu          , Xu          , Xu          , Xu          , Xu          , Xu          , Xu          , Xu          , Xu          , Xu          , Xu          , Xu          , Xu          , Xu          , Uu          , Uu          , Uu          , Uu          , Uu          , Rr          , Uu          
