border_size=1
usage=map

Gg          , Gg          , Gg          , Hh          , Gg          , Gg          , Gg          , Gg          , Gg          , Gg          , Gg          , Gg          , Gs          , Gg          , Gg          , Gg          , Gg          , Re          , Re          , Gg          , Gg          , Gg          , Gg          , Gg          , Gs^Fp       , Gg          , Gs^Fp       , Gs^Fp       
Gg          , Gg          , Gg          , Hh          , Gg          , Gg          , Gg          , Gg          , Gg          , Gg          , Gg          , Gg          , Gs          , Gg          , Gg          , Gg          , Gg          , Re          , Re          , Gg          , Gg          , Gg          , Gg          , Gg          , Gs^Fp       , Gg          , Gs^Fp       , Gs^Fp       
Re          , Re          , Re          , Hh          , Gg          , Gg          , Gg          , Gg          , Gg          , Gg          , Gg          , Gs          , Gs          , Gs          , Gg          , Gg          , Gg          , Gg          , Re          , Gg          , Gg          , Gg          , Gg          , Hh          , Gs^Fp       , Gs^Fp       , Gg          , Gg          
Gg          , Gg          , Gg          , Re          , Re          , Gg^Vh       , Gg          , Gg          , Hh          , Hh          , Gs          , Gs          , Ce          , Ce          , Ce          , Gg          , Gg          , Gg^Vh       , Re          , Gg          , Gg          , Gg          , Gg          , Hh          , Gg          , Gg          , Gg          , Gg          
Gg          , Gg          , Gg          , Gg          , Re          , Gg          , Gs          , Gg          , Gs          , Gg          , Gs          , Gs          , Ce          , 4 Ke        , Ce          , Gg          , Gg          , Re          , Gg          , Gg          , Gg          , Gg          , Gg          , Hh          , Gg          , Gs^Fp       , Gs^Fp       , Gs^Fp       
Gg          , Gg          , Gg          , Gg          , Re          , Gs          , Gs          , Gs          , Gs          , Gs          , Gs          , Gs          , Gs          , Ce          , Gs          , Gs          , Gg          , Re          , Gg          , Gg          , Gg          , Gg          , Gg          , Gg          , Gg          , Gg          , Gs^Fp       , Gs^Fp       
Gg          , Gg          , Gg          , Gg          , Gg          , Re          , Gs          , Gs          , Gs          , Gs          , Gs          , Gs          , Gs          , Gs          , Gs          , Gs          , Re          , Re          , Gg          , Gg          , Gg          , Gg          , Gg          , Hh          , Gg          , Gg          , Ww          , Ww          
Gg          , Gg          , Gg          , Gg          , Gg          , Re          , Gg          , Gg          , Gg          , Gg          , Gg          , Gs          , Gg          , Gs          , Re          , Re          , Gg          , Gg          , Gs^Fp       , Gg          , Gg          , Gg          , Gg          , Gg          , Ww          , Ww          , Gg          , Gg          
Gg          , Gg          , Gg          , Gg          , Gg          , Re          , Gg          , Gg          , Gg          , Gg          , Gg          , Gg          , Gg          , Re          , Gg          , Gg          , Gs^Fp       , Gg          , Gs^Fp       , Gg          , Gg          , Gg          , Ww          , Gg          , Ww          , Hh          , Hh          , Hh          
Gg          , Gg          , Gg          , Gg          , Gg          , Re          , Gg^Vh       , Gg          , Gg          , Gg          , Gg          , Gg          , Gg          , Re          , Gg          , Gs^Fp       , Ss          , Gs^Fp       , Gs^Fp       , Gg          , Ww          , Ww          , Gg          , Ww          , Hh          , Hh          , Hh          , Hh          
Gg          , Gg          , Gg          , Gg          , Gg          , Re          , Re          , Gg          , Gg          , Gg          , Re          , Ggf         , Re          , Re          , Gg          , Gs^Fp       , Gg          , Ss          , Gg          , Ww          , Gg          , Gg          , Gg          , Hh          , Hh          , Hh          , Hh          , Hh          
Gg          , Gg          , Gg          , Gg          , Gg          , Gg          , Gg          , Re          , Re          , Re          , Ggf         , Re          , Gg          , Gg          , Gg          , Gg          , Ww          , Gg          , Ww          , Ww          , Gg          , Gg          , Gg          , Hh          , Hh          , Hh          , Hh          , Hh          
Re^Gvs      , Gg          , Gg          , Gg          , Gg          , Gg          , Gg^Vh       , Re          , Gg          , Gg          , Gg          , Gg          , Gg          , Gg          , Gg^Vh       , Ww          , Gs          , Ww          , Gs          , Ww          , Gg          , Gg          , Gg^Vh       , Hh          , Hh          , Hh          , Gg          , Gg          
Re^Gvs      , Re^Gvs      , Re^Gvs      , Re^Gvs      , Gg          , Gg          , Gg          , Re          , Gs          , Gs          , Gs          , Gg          , Gg          , Gg          , Ds          , Ww          , Gs          , Gs          , Gs          , Ww          , Re^Gvs      , Gg          , Gg          , Gg          , Gg          , Hh          , Gg          , Gg          
Re^Gvs      , Re^Gvs      , Re^Gvs      , Re^Gvs      , Gs          , Gg          , Re          , Re          , Gs          , Gs          , Gs          , Gg          , Gg          , Gg          , Ww          , Ww          , Gs          , Gs          , Gs          , Ww          , Re^Gvs      , Re^Gvs      , Re^Gvs      , Gg          , Gg          , Gg          , Gg          , Gg          
Re^Gvs      , Re^Gvs      , Gs          , Gs          , Gs          , Gs          , Re          , Gs          , Gs          , Gs          , Re^Gvs      , Gg          , Gg          , Ds          , Ww          , Gs          , Gs          , Gs          , Ww          , Ww          , Re^Gvs      , Re^Gvs      , Re^Gvs      , Re^Gvs      , Re^Gvs      , Gg          , Gg          , Gg          
Gs          , Gs          , Gs          , Gs          , Gs          , Gs          , Re          , Gs          , Re^Gvs      , Re^Gvs      , Re^Gvs      , Re^Gvs      , Gg          , Gg^Vh       , Ww          , Gs          , Ww          , Gs          , Ww          , Ww          , Re^Gvs      , Re^Gvs      , Gg          , Re^Gvs      , Re^Gvs      , Re^Gvs      , Gg          , Gg          
Gg          , Gg          , Gg          , Gg          , Gg          , Ggf         , Re          , Gs          , Re^Gvs      , Re^Gvs      , Re^Gvs      , Re^Gvs      , Gs          , Gg          , Ww          , Gs          , Ww          , Ww          , Gs^Fp       , Ww          , Gs^Fp       , Gg          , Gs^Fp       , Gg          , Gg          , Re^Gvs      , Gg          , Gg          
Gg          , Gg          , Gg          , Gg          , Gg          , Gg          , Re          , Gs          , Gs          , Re^Gvs      , Re^Gvs      , Re^Gvs      , Gs          , Gs          , Ww          , Ww          , Ds          , Gs^Fp       , Ss          , Ww          , Gs^Fp       , Gs^Fp       , Gs^Fp       , Gg          , Gg          , Gg          , Gg          , Gg          
Re          , Gg          , Gg          , Gg          , Gg          , Gg          , Re          , Gs          , Gs          , Gs          , Gs          , Gs          , Gs          , Gs          , Ww          , Ds          , Gs^Fp       , Gs^Fp       , Gs^Fp       , Ww          , Gg          , Gg^Ve       , Gs^Fp       , Gg          , Gg          , Gg          , Gg          , Gg          
Gg          , Re          , Gg          , Gs^Fp       , Re          , Re          , Ggf         , Re          , Re          , Gs          , Gg          , Gg          , Gg          , Gg          , Ww          , Gg          , Gs^Fp       , Gs^Fp       , Gs^Fp       , Ww          , Gg          , Gs^Fp       , Hh          , Gs^Fp       , Gs^Fp       , Gs^Fp       , Gs^Fp       , Gs^Fp       
Gg          , Re          , Re          , Re          , Gg          , Gg^Vh       , Ggf         , Ggf         , Gg          , Re          , Re          , Gg          , Gg          , Gg          , Ww          , Gg          , Gg          , Ds          , Ds          , Ww          , Gs^Fp       , Gg          , Hh          , Gg          , Hh          , Gs^Fp       , Gg          , Gg          
Re          , Re          , Gg          , Gg          , Gs          , Gs          , Gs          , Gg^Wm       , Gg          , Gg          , Ce          , Re          , Re          , Gg          , Ww          , Gg          , Gg          , Ds          , Ww          , Ww          , Gg          , Gs^Fp       , Hh          , Mm          , Mm          , Hh          , Hh          , Hh          
Gg          , Gg          , Ggf         , Gg          , Gs          , Gs          , Gs          , Gg          , Gg          , Ce          , 3 Ke        , Ce          , Ww          , Ww^Bw\      , Re          , Gg          , Ww          , Ww          , Ds          , Ds          , Hh          , Gs^Fp       , Hh          , Hh          , Mm          , Hh          , Gs          , Gs          
Gg          , Gg          , Gg          , Gs          , Gs          , Gs          , Hh          , Hh          , Gg          , Ce          , Ww          , Ww          , 1 Ke        , Ce          , Re          , Gg^Vh       , Ww          , Ds          , Hh          , Hh          , Hh          , Hh          , Hh          , Hh          , Hh          , Hh          , Gs          , Gs          
Gg          , Gg          , Gg^Gvs      , Gs^Gvs      , Gs^Gvs      , Gs          , Hh          , Hh          , Ww          , Ww          , Gg          , Ce          , Ce          , Ce          , Re          , Hh          , Ww          , Ds          , Hh          , Hh          , Hh          , Hh          , Hh          , Hh^Vhh      , Gs          , Gs          , Gs          , Gs          
Gg          , Gg^Gvs      , Gg^Gvs      , Gg^Gvs      , Gg^Gvs      , Ww          , Ww          , Ww          , Gg^Gvs      , Gg          , Gg          , Gg          , Gg          , Gg          , Ww          , Ww^Bw\      , Re          , Ds          , Hh          , Hh          , Hh          , Hh          , Hh          , Gs          , Gs          , Gs          , Gs^Vht      , Gs          
Gg          , Gg          , Gg          , Gg^Gvs      , Gg          , Ww          , Gg^Vh       , Gg^Gvs      , Gg^Gvs      , Gg          , Gg          , Gg          , Ww          , Ww          , Gs          , Hh^Vhh      , Re          , Ds          , Hh          , Hh          , Hh          , Hh^Vhh      , Hh          , Gs          , Gs          , Gs          , Gs          , Gs          
Gg          , Gg          , Gg          , Gg          , Gg          , Ww          , Gg^Gvs      , Gg^Gvs      , Ww          , Gg          , Gg^Vh       , Gg^Gvs      , Ww          , Gs          , Gs          , Gs          , Hh          , Re          , Re          , Hh          , Gg          , Hh          , Gs          , Gs          , Gs          , Gs          , Re^Gvs      , Gs          
Gg          , Gg          , Gg          , Gg          , Ss          , Ww          , Ww          , Ww          , Gs          , Ww          , Ww          , Ww          , Gs          , Gs          , Gs          , Gs          , Re^Gvs      , Gs          , Gs          , Re          , Gs          , Gs          , Gs          , Gs          , Gs          , Gs          , Re^Gvs      , Re^Gvs      
Gg          , Gg          , Gg          , Ss          , Ww          , Ww          , Gg          , Gs^Vl       , Gll^Fp      , Gs          , Gs^Fds      , Gg          , Gs^Fds      , Gs          , Gs          , Re^Gvs      , Re^Gvs      , Re^Gvs      , Gs          , Re          , Gs          , Gs^Vc       , Gg^Efm      , Gs          , Gs          , Re^Gvs      , Re^Gvs      , Re^Gvs      
Gg          , Gg          , Ww          , Ww          , Gg          , Gg          , Gs^Fp       , Gll^Fp      , Gll^Fp      , Gll^Fp      , Gs          , Gs^Fds      , Gs          , Gs          , Hh          , Re^Gvs      , Re^Gvs      , Re^Gvs      , Gs          , Re          , Ggf         , Gs          , Gs          , Gs          , Re^Gvs      , Re^Gvs      , Re^Gvs      , Re^Gvs      
Ww          , Ww          , Ds          , Gg          , Gg          , Gs^Fms      , Gg          , Gs^Fds      , Hh          , Gs          , Hh          , Hh          , Hh          , Hh          , Hh          , Re^Gvs      , Re^Gvs      , Re^Gvs      , Gs          , Re          , Gg          , Gg^Wm       , Gs          , Gs          , Re^Gvs      , Re^Gvs      , Re^Gvs      , Re^Gvs      
Ds          , Ds          , Ds          , Ds          , Ds          , Gg          , Hh          , Hh          , Hh          , Hh          , Hh          , Hh          , Hh^Vhh      , Hh          , Hh          , Gs          , Gs          , Re^Gvs      , Gs          , Re          , Re          , Gg          , Gs          , Gs          , Re^Gvs      , Re^Gvs      , Re^Gvs      , Re^Gvs      
Rrc         , Rrc         , Rrc         , Ds          , Gg          , Gg          , Hh          , Hh          , Hh          , Hh          , Hh          , Hh          , Hh          , Hh          , Hh          , Hh          , Hh          , Gs          , Gg          , Gs          , Re          , Re          , Re          , Gs          , Gg          , Re^Gvs      , Re^Gvs      , Re^Gvs      
Gg          , Gg          , Rrc         , Gg          , Gg          , Gg          , Gg          , Hh          , Hh          , Hh          , Hh          , Hh          , Hh          , Hh          , Hh          , Hh          , Hh          , Hh^Vhh      , Re          , Re          , Gs^Fp       , Ggf         , Gs^Fp       , Re          , Re          , Gg          , Gg          , Re^Gvs      
Gg          , Gg          , Gs^Fp       , Rrc         , Gg^Gvs      , Gg          , Gg^Gvs      , Gg          , Gg          , Hh          , Hh          , Hh          , Hh          , Hh          , Hh          , Hh          , Hh          , Re          , Hh          , Gs^Fp       , Gs^Fp       , Gs^Fp       , Gs^Vl       , Gs^Fp       , Gs^Fds      , Re          , Re          , Re          
Gs^Fp       , Gs^Fp       , Gg^Ve       , Rrc         , Rrc         , Gg^Gvs      , Gg^Gvs      , Gg^Gvs      , Gg^Gvs      , Gg          , Hh          , Hh          , Hh          , Hh          , Hh          , Hh          , Hh          , Re          , Hh          , Hh          , Gs^Fds      , Gs^Fds      , Gs^Fds      , Gs^Fds      , Gs^Fds      , Gg          , Hh          , Hh          
Gs^Fp       , Gs^Fp       , Gg          , Gs^Fp       , Rrc         , Gs^Fp       , Gs^Fp       , Gg^Gvs      , Gg^Gvs      , Gg          , Gg          , Hh          , Hh          , Hh          , Hh^Vhh      , Hh          , Re          , Re          , Hh          , Hh          , Gg          , Gs^Fds      , Hh          , Gs^Fds      , Hh          , Hh          , Hh          , Hh          
Gs^Fp       , Gs^Fp       , Hh          , Gg          , Gg          , Rrc         , Gs^Fp       , Gg^Gvs      , Gg^Gvs      , Gg          , Gg          , Hh          , Hh          , Hh          , Hh          , Re          , Hh          , Hh          , Hh^Vhh      , Hh          , Hh          , Hh          , Hh          , Hh          , Hh          , Hh          , Hh          , Hh          
Gg          , Gg          , Hh          , Hh          , Hh          , Rrc         , Gs^Fp       , Gg^Gvs      , Gg^Gvs      , Gg          , Gg          , Hh          , Hh          , Hh          , Hh          , Re          , Hh          , Hh          , Hh          , Hh          , Hh          , Hh          , Hh          , Hh          , Hh          , Hh          , Hh          , Hh          
Hh          , Hh          , Hh          , Mm          , Dd          , Rrc         , Gs^Fp       , Gg^Gvs      , Gg^Gvs      , Gg          , Gg          , Hh          , Gg          , Hh          , Re          , Re          , Hh          , Hh          , Ce          , Gg          , Hh          , Hh          , Hh          , Hh          , Mm          , Mm          , Mm          , Mm          
Gs^Fp       , Gs^Fp       , Hh          , Dd          , Dd          , Rrc         , Rrc         , Gg^Vh       , Re          , Re          , Re          , Hh          , Re          , Re          , Hh          , Hh          , Re          , Ce          , 2 Ke        , Ce          , Hh          , Hh          , Hh          , Hh          , Mm          , Mm          , Mm          , Mm          
Gs^Fp       , Gs^Fp       , Hh          , Dd          , Gg          , Gg          , Gg          , Rrc         , Rrc         , Gg          , Gg          , Re          , Gg          , Re          , Re          , Re          , Gs^Fp       , Ce          , Ce          , Ce          , Gs^Fds      , Hh          , Hh          , Mm          , Hh          , Mm          , Hh          , Hh          
Gg          , Gg          , Gg          , Dd          , Dd          , Gg          , Dd          , Gg          , Gg          , Rrc         , Gg          , Gg          , Gg          , Gg          , Gg          , Gg          , Gg          , Gg          , Gg          , Gg          , Gs^Fds      , Gs^Fds      , Gg          , Hh          , Hh          , Mm          , Hh          , Hh          
Gg          , Gg          , Gg          , Gg          , Dd          , Dd          , Dd          , Gg          , Gg          , Rrc         , Rrc         , Gg          , Gg          , Gg          , Gg          , Gg          , Gg          , Gg          , Gg          , Gg          , Gs^Fp       , Gs^Fp       , Gg          , Gg          , Hh          , Hh          , Hh          , Hh          
Gg          , Gg          , Gg          , Gg          , Dd          , Dd          , Dd          , Gg          , Gg          , Rrc         , Rrc         , Gg          , Gg          , Gg          , Gg          , Gg          , Gg          , Gg          , Gg          , Gg          , Gs^Fp       , Gs^Fp       , Gg          , Gg          , Hh          , Hh          , Hh          , Hh          
