border_size=1
usage=map

Mm          , Mm          , Mm          , Mm          , Mm          , Mm          , Mm          , Mm          , Mm          , Mm          , Mm          , Mm          , Mm          , Mm          , Mm          , Ha          , Ha          , Ha          , Gg          , Gg          , Gg          , Gg          , Gg          , Re          , Gg          , Aa          , Aa          , Gg          , Gg          , Gg          , Gg          , Ww          , Ww          , Ww          , Ww          , Wo          , Wo          , Wo          , Wo          , Wo          , Wo          , Wo          
Mm          , Mm          , Mm          , Mm          , Mm          , Mm          , Mm          , Mm          , Mm          , Mm          , Mm          , Mm          , Mm          , Mm          , Mm          , Ha          , Ha          , Ha          , Gg          , Gg          , Gg          , Gg          , Gg          , Re          , Gg          , Aa          , Aa          , Gg          , Gg          , Gg          , Gg          , Ww          , Ww^Vm       , Ww          , Ww          , Wo          , Wo          , Wo          , Wo          , Wo          , Wo          , Wo          
Mm          , Mm          , Mm          , Mm          , Mm          , Mm          , Mm          , Mm          , Mm          , Mm          , Mm          , Mm          , Mm          , Mm          , Mm          , Ha          , Ha          , Ha          , Gg          , Gg          , Gg          , 4 Rd        , Re          , Re          , Gg          , Aa          , Ha          , Gg          , Gg          , Gg          , Gg          , Ww          , Ww          , Ww          , Ww          , Ww          , Ww          , Wo          , Wo          , Wo          , Wo          , Wo          
Mm          , Mm          , Mm          , Mm          , Mm          , Mm          , Mm          , Mm          , Mm          , Mm          , Hh          , Hh          , Mm          , Mm          , Mm          , Hh          , Hh          , Gg          , Gg          , Gg          , Rd          , Re          , Gg          , Gg          , Hh          , Hh          , Ms          , Hh          , Gg          , Gg          , Gg          , Ds          , Ds          , Ds          , Ww          , Ww          , Ww          , Ww          , Wo          , Wo          , Wo          , Wo          
Mm          , Mm          , Mm          , Mm          , Mm          , Mm          , Hh          , Gg          , Gg          , Gg          , Gg          , Hh          , Mm          , Mm          , Mm          , Hh          , Gg          , Gg          , Gg          , Gg          , Rd          , Hh          , Gg          , Gg          , Hh          , Mm          , Mm          , Hh          , Hh          , Gg          , Gg          , Gg          , Ds          , Ds          , Ww          , Ww          , Ww          , Wo          , Wo          , Wo          , Wo          , Wo          
Mm          , Mm          , Mm          , Mm          , Mm          , Hh          , Hh^Vhh      , Hh          , Hh          , Gg          , Gg          , Gg          , Gg          , Hh^Vhh      , Gg          , Gg          , Gg          , Gg          , Gg          , Gg          , Rd          , Gg          , Gg          , Gg          , Gg          , Hh          , Hh          , Mm          , Hh          , Gg          , Gg          , Gg          , Ww          , Ww          , Ds          , Ww          , Wo          , Wo          , Wo          , Wo          , Mm          , Mm          
Mm          , Mm          , Mm          , Mm          , Hh          , Hh          , Gg          , Gg          , Gg          , Gg          , Gg          , Gg          , Gs^Fds      , Gg          , Gg          , Gg          , Gg          , Gg          , Gg          , Aa          , Rd          , Gg          , Gg          , Gg          , Gg          , Hh          , Hh          , Hh          , Gg          , Gg          , Ww          , Ww          , Gg          , Ds          , Ds          , Ww          , Wo          , Wo          , Ww^Vm       , Wo          , Mm          , Mm          
Mm          , Mm          , Mm          , Hh          , Gg          , Hh          , Gs^Fds      , Gg          , Gs^Fds      , Gs^Fds      , Gs^Fds      , Gs^Fds      , Gg          , Gs^Fds      , Gs^Fds      , Gs^Fds      , Gg          , Gg          , Gg          , Aa          , Rb          , Rd          , Re          , Aa          , Aa          , Ha          , Ha          , Ha          , Gg          , Ww          , Gg          , Gg          , Gg          , Gg          , Ds          , Ww          , Ww          , Ww          , Hh          , Mm          , Mm          , Mm          
Mm          , Hh          , Hh          , Gg          , Hh          , Hh          , Gg          , Gs^Fds      , Gg          , Gg          , Gg          , Gg          , Gg          , Gg          , Gg          , Gg          , Gg          , Gg          , Gg          , Gs^Fp       , Rb          , Hh          , Mm          , Hh          , Re          , Re          , Re          , Ha          , Re          , Ww          , Re          , Gg          , Gg          , Gg          , Gg          , Ds          , Gg          , Hh          , Mm          , Mm          , Mm          , Mm          
Mm          , Hh          , Gg          , Gg          , Hh^Fds      , Gs^Fds      , Gg          , Gg          , Gs^Fp       , Gs^Fp       , Gs^Fp       , Gg          , Gg          , Gg          , Gg          , Gg          , Gg          , Gg          , Hh          , Rb          , Hh          , Mm^Vhh      , Mm          , Hh          , Gg          , Gg          , Gg          , Re          , Ds          , Wwf         , Ds          , Re          , Re          , Gg          , Gg          , Gg          , Hh          , Hh          , Mm          , Mm          , Mm          , Mm          
Mm          , Hh          , Hh^Fds      , Hh^Fds      , Hh^Fds      , Hh^Fds      , Gg          , Gg          , Gs^Fp       , Gg          , Gs^Fp       , Hh          , Hh          , Gg          , Gg          , Gg          , Gg          , Gg          , Rb          , Rb          , Hh          , Mm          , Hh          , Hh          , Gg          , Gg          , Ds          , Ds          , Ww          , Ww          , Ww          , Ds          , Re          , Gg          , Gg          , Gg          , Gg          , Hh          , Hh          , Mm          , Mm          , Mm          
Mm          , Hh          , Gg          , Hh          , Gg          , Gg          , Gg          , Gg          , Gg^Ve       , Gs^Fp       , Gg          , Gs^Fp       , Gs^Fp       , Gs^Fp       , Gg^Vh       , Gg          , Gg          , Rb          , Gg          , Gg          , Gs^Fp       , Hh          , Hh          , Hh          , Gg          , Gg          , Ai          , Ww          , Gg          , Ds          , Ww          , Ds          , Ds          , Re          , Re          , Gg          , Gg          , Hh          , Hh          , Mm          , Mm          , Mm          
Mm          , Hh          , Hh          , Hh^Vhh      , Hh          , Gg          , Gg          , Gg          , Gs^Fp       , Gs^Fp       , Gs^Fp       , Gs^Fp       , Gs^Fp       , Gg          , Gg          , Gg          , Gg          , Rb          , Gs^Fp       , Gs^Fp       , Gs^Fp       , Gs^Fp       , Mm          , Hh          , Ha          , Aa          , Ai          , Gg          , Gg          , Ww          , Ww          , Ww          , Gg^Vh       , Gs^Fp       , Re          , Gg          , Gg^Vh       , Hh          , Ms          , Mm          , Mm          , Mm          
Mm          , Mm          , Mm          , Hh          , Hh          , Hh          , Hh          , Gg          , Gg          , Gs^Fp       , Gs^Fp       , Gs^Fp       , Gs^Fp       , Hh^Fp       , Hh^Fp       , Gg          , Rb          , Rb          , Gs^Fp       , Gs^Fp       , Gs^Fp       , Hh          , Hh          , Mm          , Ha          , Gg          , Gg          , Ww          , Ww          , Ww          , Gg          , Gg          , Gs^Fp       , Gs^Fp       , Re          , Gg          , Aa          , Ha          , Ha          , Ms          , Mm          , Mm          
Mm          , Mm          , Mm          , Mm          , Hh          , Hh          , Hh          , Gg          , Gg          , Gg          , Hh          , Hh          , Hh          , Hh          , Hh          , Hh^Fp       , Re          , Hh          , Hh          , Gs^Fp       , Gg          , Gg          , Gg          , Gg          , Gg          , Gg          , Gg          , Gg          , Ww          , Gg          , Gs^Fp       , Gs^Fp       , Gs^Fp       , Gs^Fp       , Re          , Gg          , Ha          , Mm          , Ha          , Gg          , Mm          , Mm          
Mm          , Mm          , Mm          , Mm          , Hh          , Hh          , Hh          , Gg          , Gg          , Gg          , Ha          , Ms          , Ms          , Mm          , Ha          , Re          , Gg          , Gs^Fp       , Gs^Fp       , Hh          , Gg          , Gg          , Gs^Fds      , Gg          , Gs^Fds      , Gg          , Gg          , Gg          , Ww          , Gg          , Gs^Fp       , Gs^Fp       , Gg^Ve       , Gs^Fp       , Re          , Hh          , Mm          , Mm          , Mm          , Mm          , Mm          , Mm          
Mm          , Mm          , Mm          , Hh          , Hh          , Hh          , Hh          , Hh          , Gg          , Gg          , Gg          , Gg          , Ha          , Ha          , Re          , Re          , Gs^Fp       , Gs^Fp       , Gs^Fp       , Hh          , Hh          , Gg          , Gg          , Gs^Fds      , Gg          , Gg          , Gg          , Gg          , Ww          , Gg          , Gg          , Gg          , Gg          , Re          , Hh          , Mm          , Mm          , Mm          , Mm          , Mm          , Mm          , Mm          
Mm          , Mm          , Hh          , Hh          , Hh          , Hh          , Hh          , Hh          , Hh          , Gg          , Gg          , Gg          , Gg          , Gg          , Re          , Re          , Gs^Fp       , Gg^Ve       , Gs^Fp       , Gs^Fp       , Gg          , Gg          , Gg          , Gg          , Gg          , Ww          , Ww          , Gg          , Wwf         , Gg          , Gg          , Gg          , Gg          , Re          , Hh          , Mm          , Mm          , Mm          , Mm          , Mm          , Hh          , Hh          
Mm          , Mm          , Hh          , Hh          , Hh          , Hh          , Mm          , Mm^Vhh      , Hh          , Gs^Fp       , Gs^Fp       , Gg          , Gg          , Re          , Gs^Fp       , Gs^Fp       , Gs^Fp       , Gs^Fp       , Gs^Fp       , Gg          , Gg          , Gg          , Ww          , Gg^Vh       , Ww          , Ww          , Ai          , Ww          , Gg          , Gg          , Gg          , Gg          , Gg          , Re          , Hh          , Mm          , Hh          , Mm          , Hh          , Hh          , Rr          , Rr          
Hh          , Hh          , Hh          , Hh          , Hh          , Mm          , Mm          , Hh          , Hh          , Gs^Fp       , Gs^Fp       , Gs^Fp       , Re          , Re          , Hh          , Hh          , Mm          , Hh          , Hh          , Gg          , Gg          , Ww          , Ww          , Ww          , Ww          , Ww          , Gg          , Gg          , Gg          , Gg          , Gg          , Hh          , Hh          , Re          , Re          , Hh          , Hh          , Hh          , Rr          , Rr          , Gs^Fp       , Gs^Fp       
Hh          , Hh          , Hh          , Gg          , Gg          , Gg          , Gs^Vl       , Hh          , Gs^Fp       , Gs^Fp       , Gs^Fp       , Gs^Fp       , Re          , Gs^Fp       , Gs^Fp       , Mm          , Mm          , Hh          , Gg          , Gg          , Gg          , Ww          , Ww          , Ww          , Ww          , Ww          , Gg          , Gg          , Gg          , Gg          , Gg          , Hh          , Hh          , Gg          , Re          , Hh          , Rr          , Rr          , Hh          , Hh          , Hh          , Hh          
Hh          , Hh          , Hh          , Ha          , Gg          , Aa          , Gg          , Gs^Fp       , Gs^Fp       , Gs^Fp       , Gs^Fp       , Gs^Fp       , Re          , Gs^Fp       , Hh          , Mm          , Hh          , Hh          , Hh          , Gg          , Gg          , Wo          , Wo          , Ww          , Gg          , Gg          , Gg          , Gg          , Gg          , Gg          , Gg          , Hh          , Hh          , Gg          , Gg          , Rr          , Gs^Fp       , Gs^Fp       , Gs^Fp       , Hh          , Gg          , Gg          
Mm          , Mm          , Hh^Vhh      , Ha          , Gg          , Aa          , Gg          , Gg          , Re          , Gg          , Re          , Re          , Gs^Fp       , Hh          , Gs^Fp       , Mm          , Hh          , Hh          , Hh          , Hh          , Ww          , Wo          , Wo          , Hh          , Gg          , Gg          , Gg          , Mm          , Mm          , Mm          , Mm          , Hh          , Gg          , Gg          , Gg          , Rr          , Rr          , Gs^Fp       , Gs^Fp       , Gg          , Gg          , Gg          
Mm          , Mm          , Hh          , Gg          , Gg          , Gg          , Re          , Re          , Hh          , Hh          , Hh          , Hh          , Hh          , Hh          , Gs^Fp       , Gs^Fp       , Gs^Fp       , Hh          , Hh          , Gg          , Ww          , Mm          , Ha          , Ha          , Ha          , Mm          , Mm          , Mm          , Mm          , Mm          , Hh          , Hh          , Gg          , Gs^Fp       , Gs^Fp       , Gs^Fp       , Gg          , Rr          , Gg          , Gg          , Gg          , Gg          
Ha          , Ha          , Ha          , Gg          , Re          , Re          , Hh          , Hh          , Mm^Vhh      , Hh          , Mm          , Mm          , Mm          , Hh          , Hh          , Gs^Fp       , Gs^Fp       , Gg^Vh       , Hh          , Mm          , Ww          , Mm          , Mm          , Mm          , Mm          , Mm          , Mm          , Mm          , Gg          , Gg          , Gg          , Hh          , Gg          , Gg^Ve       , Gs^Fp       , Gs^Fp       , Gg          , Rb          , Gg          , Gg          , Gg          , Gg          
Ha          , Ha          , Gg          , Gg          , Gs^Fp       , Gs^Fp       , Mm          , Mm          , Mm          , Hh          , Mm          , Mm          , Mm          , Hh          , Hh          , Gs^Fp       , Gg          , Hh          , Mm          , Mm          , Wwf         , Mm          , Mm          , Mm          , Mm^Xm       , Mm          , Mm          , Mm          , Gg          , Gg          , Gg          , Hh          , Gg          , Gs^Fp       , Gs^Fp       , Gs^Fp       , Gg          , Rr          , Gg          , Gg          , Gg          , Gg          
Hh          , Hh          , Ds          , Gs^Fp       , Gg^Ve       , Hh          , Mm          , Mm          , Cud         , Mm          , Mm          , Mm          , Mm          , Hh          , Hh^Vhh      , Hh          , Gg          , Hh          , Ww          , Wo          , Wo          , Mm          , Mm          , Mm^Xm       , Ms          , Ms          , Ms          , Ha          , Hh          , Hh          , Hh          , Ha          , Gg          , Gg          , Hh          , Hh          , Ww          , Ww^Bw|      , Ww          , Ww          , Ww          , Ww          
Gg          , Gg          , Ds          , Gs^Fp       , Gs^Fp       , Hh          , Mm          , Cud         , 2 Kud       , Cud         , Gg          , Mm          , Mm          , Hh          , Gg          , Gg          , Gg          , Hh          , Ww          , Wo          , Mm          , Mm          , Mm          , Mm          , Ms          , Ha          , Mm          , Mm          , Mm          , Mm          , Mm          , Ha          , Gg          , Hh          , Mm          , Mm          , Ww          , Ww^Bw|      , Gg          , Gg          , Gg          , Gg          
Gs^Fp       , Gs^Fp       , Gs^Fp       , Gs^Fp       , Hh          , Mm          , Mm          , Cud         , Cud         , Cud         , Mm          , Hh          , Hh          , Hh          , Gg          , Gg          , Wwf         , Ww          , Hh          , Ww          , Hh          , Mm          , Mm          , Mm          , Mm          , Mm          , Mm^Xm       , Mm          , Mm          , Mm          , Ms          , Ms          , Hh          , Hh          , Hh          , Ww          , Gg          , Ce          , 1 Ke        , Ce          , Gg          , Gg          
Gs^Fp       , Gs^Fp       , Gs^Fp       , Gs^Fp       , Hh          , Mm          , Mm          , Mm          , Mm          , Mm          , Mm          , Mm          , Hh          , Gg          , Ww          , Ww          , Hh          , Gg          , Hh          , Hh          , Hh          , Mm          , Mm          , Mm^Vhh      , Mm          , Mm^Xm       , Mm^Xm       , Mm^Xm       , Mm          , Mm          , Ms          , Ha          , Ai          , Gg          , Gg          , Ww          , Hh          , Ce          , Rr          , Ce          , Hh          , Hh          
Gs^Fp       , Gs^Fp       , Hh          , Hh          , Hh          , Mm          , Mm          , Hh          , Ha          , Ms          , Mm          , Hh          , Gg          , Gg          , Ww          , Hh          , Ch          , Ch          , Ch          , Hh          , Hh          , Mm          , Mm          , Mm          , Mm          , Mm^Xm       , Mm^Xm       , Mm          , Mm          , Mm          , Ha          , Ai          , Aa          , Ww          , Ww          , Ww          , Gg          , Gg          , Rr          , Hh          , Hh          , Hh          
Gg          , Gg          , Hh          , Hh          , Hh          , Hh          , Hh          , Hh          , Ha          , Ms          , Hh          , Gg          , Gg          , Gg          , Ww          , Mm          , Mm          , Chr         , Ch          , Hh          , Mm          , Mm          , Mm          , Mm          , Mm^Xm       , Mm^Xm       , Mm          , Mm          , Mm          , Mm          , Ha          , Aa          , Aa          , Gg          , Ww          , Ww          , Gg          , Gg          , Rb          , Rr          , Rb          , Hh          
Gg          , Gg          , Hh          , Hh          , Hh          , Hh          , Gg          , Gg          , Gg          , Gg          , Gg          , Gg          , Ww          , Ww          , Gg          , Mm          , Mm          , Mm          , Mm          , Mm          , Mm^Xm       , Mm          , Mm^Xm       , Mm^Xm       , Mm          , Mm          , Hh          , Hh          , Hh          , Gg          , Gg          , Gg          , Rb          , Gg          , Rb          , Gg          , Rb          , Rb          , Gg          , Gg          , Gg          , Rb          
Gg          , Gg          , Gg          , Gg          , Gg          , Hh          , Gg          , Gg          , Gg          , Aa          , Ai          , Gg          , Ww          , Gg          , Hh          , Mm          , Mm          , Mm^Xm       , Mm^Xm       , Mm^Xm       , Mm^Xm       , Mm^Xm       , Mm^Xm       , Mm          , Mm          , Hh          , Hh          , Gg          , Gg          , Gg          , Rb          , Rb          , Gg          , Rb          , Gg          , Rb          , Gg          , Gg          , Gg          , Gg          , Gg          , Gg          
Gg          , Gg          , Gg          , Gg^Vh       , Gg          , Gg          , Gg          , Gg          , Gg          , Gg^Vh       , Gg          , Ww          , Aa          , Ha          , Ms          , Mm          , Mm          , Mm^Xm       , Mm^Xm       , Mm^Xm       , Mm^Xm       , Mm^Xm       , Hh          , Hh          , Gg          , Hh          , Rb          , Rb          , Rb          , Rb          , Gg          , Gg          , Gg          , Hh          , Hh          , Gg          , Gg          , Gg          , Gg          , Gg          , Hh          , Gg          
Gg          , Gg          , Gg          , Gg          , Gg          , Gg          , Gg          , Gg          , Gg          , Gg          , Gg          , Ai          , Ai          , Ai          , Ms          , Ms          , Mm^Xm       , Mm^Xm       , Mm^Xm       , Mm^Xm       , Mm          , Mm          , Gg          , Gg          , 3 Gg        , Gg          , Rb          , Rb          , Gg          , Hh          , Hh          , Hh          , Hh          , Gg          , Hh          , Hh          , Hh          , Gg          , Hh          , Gg          , Hh          , Gg          
Hh          , Hh          , Ha          , Gg          , Gg          , Gg          , Gg          , Gg          , Gg          , Gg          , Ww          , Ww          , Ai          , Ai          , Mm          , Mm          , Mm^Xm       , Mm^Xm       , Mm^Xm       , Mm^Xm       , Mm          , Hh          , Gg          , Gg          , Rb          , Rb          , Gg          , Gg          , Mm          , Mm          , Mm          , Mm          , Mm          , Hh          , Mm          , Mm          , Mm          , Hh          , Mm          , Mm          , Mm          , Mm          
Hh          , Hh          , Ha          , Gg          , Gg          , Gg          , Gg          , Gg          , Gg          , Gg          , Ww          , Ww          , Ai          , Ai          , Gg          , Mm          , Mm^Xm       , Mm^Xm       , Mm^Xm       , Mm^Xm       , Mm          , Hh          , Gg          , Gg          , Rb          , Gg          , Mm          , Mm          , Mm          , Mm          , Mm          , Mm          , Mm          , Mm          , Mm          , Mm          , Mm          , Mm          , Mm          , Mm          , Mm          , Mm          
