border_size=1
usage=map

    Mm^Xm,    Mm^Xm,    Mm^Xm,    Mm^Xm,       Mm,       Rd,       Rd,       Rd,       Rd,       Rd,       Rd,       Rd,       Rd,       Rd,       Rd,       Rr,       Rd,       Rd,       Rd,       Rd,       Rd,       Rd,       Re,       Mm,       Mm,    Mm^Xm,    Mm^Xm,    Mm^Xm
    Mm^Xm,    Mm^Xm,    Mm^Xm,    Mm^Xm,       Mm,       Rd,       Rd,       Rd,       Rd,       Rd,       Rd,       Rd,       Rd,       Rd,       Rd,       Rr,       Rd,       Rd,       Rd,       Rd,       Rd,       Rd,       Re,       Mm,       Mm,    Mm^Xm,    Mm^Xm,    Mm^Xm
    Mm^Xm,    Mm^Xm,       Mm,       Mm,       Rd,       Rd,       Rd,       Rd,       Rd,       Rd,       Rd,       Rd,       Rd,       Rd,       Rd,       Rr,       Rd,       Rd,       Rd,       Rd,       Hh,       Hh,       Hh,       Mm,       Mm,    Mm^Xm,    Mm^Xm,    Mm^Xm
    Mm^Xm,    Mm^Xm,       Mm,       Rd,       Rd,       Rd,       Rd,       Rd,       Ds,       Ds,       Rd,       Rd,       Rd,       Rd,       Rr,     2 Kh,       Rd,       Ds,       Ds,       Rd,       Hh,       Hh,       Hh,       Hh,       Mm,       Mm,    Mm^Xm,    Mm^Xm
    Mm^Xm,    Mm^Xm,       Mm,       Mm,       Rd,       Hd,       Dd,       Dd,       Rd,       Ds,       Rd,       Rd,       Rr,       Rr,       Rd,       Rd,       Hh,       Rd,       Ds,       Rd,       Hh,       Hh,       Hh,       Hh,       Mm,    Mm^Xm,    Mm^Xm,    Mm^Xm
    Mm^Xm,    Mm^Xm,       Mm,       Mm,       Rd,       Rd,       Hd,       Dd,       Hh,       Rd,       Rr,       Rr,       Ds,       Rd,       Rd,       Hh,       Rd,       Rd,       Rd,       Rd,       Rd,       Rd,       Rd,       Rd,       Mm,       Mm,    Mm^Xm,    Mm^Xm
    Mm^Xm,    Mm^Xm,       Mm,       Mm,       Rd,       Rd,       Hh,       Hd,       Rd,       Rd,       Rr,       Rd,       Rd,       Rd,       Rd,       Rd,       Hh,       Hh,       Rd,       Rd,       Hh,       Hh,       Hh,       Mm,       Mm,       Mm,    Mm^Xm,    Mm^Xm
    Mm^Xm,    Mm^Xm,       Mm,       Mm,       Rd,       Rd,       Rd,       Rd,       Rr,       Rr,       Rd,       Rd,       Ss,       Rd,       Rd,       Rd,       Rd,       Rd,       Rd,       Hh,       Hh,       Mm,       Mm,       Mm,       Mm,       Mm,    Mm^Xm,    Mm^Xm
    Mm^Xm,    Mm^Xm,    Mm^Xm,       Mm,       Mm,       Rd,       Rd,       Rd,       Rr,       Rd,       Rd,       Rd,       Rd,       Ss,       Rd,       Dd,       Dd,       Rd,       Rd,       Hh,       Hh,       Mm,       Mm,       Mm,    Mm^Xm,    Mm^Xm,    Mm^Xm,    Mm^Xm
    Mm^Xm,    Mm^Xm,    Mm^Xm,    Mm^Xm,       Mm,       Hh,       Rr,       Rr,       Rd,       Rd,       Rd,    Gg^Vh,       Rd,       Ss,       Rd,       Hd,       Hd,       Rd,       Rd,       Hh,       Hh,       Hh,       Hh,       Mm,       Mm,    Mm^Xm,    Mm^Xm,    Mm^Xm
    Mm^Xm,    Mm^Xm,    Mm^Xm,       Mm,       Mm,       Hh,       Rr,       Rd,       Rd,       Rd,       Rd,       Rd,       Rd,       Rd,       Rd,       Rd,       Rd,       Rd,       Rd,       Rd,       Hh,   Hh^Vhh,       Hh,       Mm,       Mm,    Mm^Xm,    Mm^Xm,    Mm^Xm
    Mm^Xm,    Mm^Xm,       Mm,    Mm^Xm,       Mm,       Hh,       Rr,       Rd,       Rd,       Rd,       Rd,       Rd,       Rd,       Rd,       Rd,       Rd,       Rd,       Rd,       Rd,       Rd,       Rd,       Hh,       Hh,       Mm,    Mm^Xm,    Mm^Xm,    Mm^Xm,    Mm^Xm
    Mm^Xm,    Mm^Xm,       Mm,       Mm,       Hh,       Hh,       Rr,       Ds,       Rd,       Rd,       Rr,       Rd,       Rr,       Rr,       Rr,       Ss,       Ss,       Rd,       Rd,       Rd,       Rd,       Hh,       Hh,       Mm,       Mm,    Mm^Xm,    Mm^Xm,    Mm^Xm
    Mm^Xm,    Mm^Xm,       Mm,       Hh,       Hh,       Hh,       Hh,       Rr,       Rr,       Rr,       Rd,       Rr,       Rd,       Rd,       Rd,       Rr,       Rr,       Hh,       Rd,       Rd,       Rd,       Rd,       Hh,       Hh,       Mm,    Mm^Xm,    Mm^Xm,    Mm^Xm
    Mm^Xm,    Mm^Xm,       Mm,       Hh,       Hh,       Hh,       Hh,       Ww,       Ds,       Rd,       Rd,       Rd,       Ds,       Rd,       Gs,       Rd,       Rd,       Rr,       Rr,       Rr,       Rr,       Rd,       Hh,       Hh,       Rd,       Mm,    Mm^Xm,    Mm^Xm
    Mm^Xm,    Mm^Xm,    Mm^Xm,       Mm,       Mm,       Hh,       Hh,       Ww,       Dd,       Ds,       Ds,       Rd,       Rd,       Gs,   Gs^Vht,       Ss,       Ss,       Rd,       Rd,       Rd,       Rd,       Rr,       Rr,       Rd,       Rd,       Mm,    Mm^Xm,    Mm^Xm
    Mm^Xm,    Mm^Xm,    Mm^Xm,    Mm^Xm,       Mm,       Mm,       Hh,       Hd,       Hd,       Rd,       Rd,       Rd,       Rd,       Rd,       Rd,       Rd,       Rd,       Rd,       Rd,       Rd,       Rd,       Rd,       Rr,       Rd,       Rd,       Mm,    Mm^Xm,    Mm^Xm
    Mm^Xm,    Mm^Xm,    Mm^Xm,       Mm,       Mm,       Mm,       Hh,       Hh,       Rd,       Rd,       Rd,       Rd,       Rd,       Ds,       Ds,       Rd,       Rd,       Rd,   Ss^Vhs,       Ds,       Rd,       Rd,       Rr,       Rd,       Mm,       Mm,    Mm^Xm,    Mm^Xm
    Mm^Xm,    Mm^Xm,       Mm,       Mm,       Mm,       Hh,       Rd,       Rd,    Gg^Vh,       Rd,       Rd,       Rd,       Rd,       Rd,       Rd,       Rd,       Rd,       Ss,       Ds,       Ds,       Ss,       Rr,       Mm,       Mm,       Mm,       Mm,    Mm^Xm,    Mm^Xm
    Mm^Xm,    Mm^Xm,       Mm,       Mm,       Hh,       Hh,       Rd,       Rd,       Rd,       Rd,       Rd,       Rd,       Rd,       Rd,       Rd,       Ds,       Ds,       Rd,       Rd,       Rd,       Rr,       Rr,       Mm,       Mm,       Mm,       Mm,    Mm^Xm,    Mm^Xm
    Mm^Xm,    Mm^Xm,       Mm,       Mm,       Hh,       Rd,       Rd,       Rd,       Rd,       Rd,       Rd,       Rd,       Rd,       Rd,       Rd,       Ss,       Ss,       Ds,       Rd,       Rr,       Hh,       Hh,       Mm,       Mm,       Mm,    Mm^Xm,    Mm^Xm,    Mm^Xm
    Mm^Xm,    Mm^Xm,       Mm,       Mm,       Hh,       Hh,       Rd,       Rd,       Rd,       Rd,       Rd,       Rd,       Rd,       Rd,   Hh^Vhh,       Rd,       Rd,       Rd,       Rr,       Rr,       Hh,       Hh,       Hh,       Mm,       Mm,    Mm^Xm,    Mm^Xm,    Mm^Xm
    Mm^Xm,    Mm^Xm,       Mm,       Mm,       Hh,       Hh,       Rd,       Rd,       Rd,       Rd,       Rd,       Rd,       Rd,       Rd,       Rd,       Rd,       Rd,       Rr,       Rd,       Ds,       Hd,       Hd,       Hd,       Hh,       Mm,    Mm^Xm,    Mm^Xm,    Mm^Xm
    Mm^Xm,    Mm^Xm,       Mm,       Hh,       Hh,       Hh,       Rd,       Rd,       Rd,       Rd,       Rd,       Rd,       Rd,       Rd,       Rd,       Rd,       Rr,       Rr,       Rd,       Ds,       Dd,       Dd,       Dd,       Hh,       Mm,    Mm^Xm,    Mm^Xm,    Mm^Xm
    Mm^Xm,    Mm^Xm,       Mm,       Hh,       Rd,       Rd,       Rd,       Rd,       Hh,       Hh,       Rd,       Rd,       Rd,       Rd,       Rr,       Rr,       Rd,       Rd,       Rd,       Rd,   Dd^Vdt,       Dd,       Rd,       Hh,       Mm,       Mm,    Mm^Xm,    Mm^Xm
    Mm^Xm,    Mm^Xm,       Mm,       Hh,       Rd,       Rd,       Rd,       Hh,       Hh,       Hh,       Hh,       Hh,       Rr,       Rr,       Rd,       Rd,       Rd,       Rd,       Rd,       Rd,       Rd,       Rd,       Rd,       Hh,       Hh,       Mm,    Mm^Xm,    Mm^Xm
    Mm^Xm,    Mm^Xm,       Mm,       Hh,       Rr,       Rr,       Rr,       Hh,       Hh,       Hh,       Hd,       Hd,       Rr,       Rd,       Rd,       Rd,       Rd,       Rd,       Rd,       Rd,       Rd,       Rd,       Rd,       Rd,       Hh,       Mm,    Mm^Xm,    Mm^Xm
    Mm^Xm,    Mm^Xm,       Mm,       Hh,       Rr,       Hh,       Hh,       Rr,       Rr,       Rr,       Rr,       Rr,       Rd,       Rd,       Rd,       Rd,       Rd,       Rd,       Rd,       Rd,       Rd,       Rd,       Hh,       Hh,       Mm,       Mm,    Mm^Xm,    Mm^Xm
    Mm^Xm,    Mm^Xm,       Mm,       Hh,       Rr,       Hh,       Rd,       Rd,       Rd,       Rd,   Dd^Vda,       Ds,       Rd,       Rd,       Rd,       Rd,       Rd,       Rd,       Ds,       Rd,       Rd,       Rd,       Hh,       Mm,    Mm^Xm,    Mm^Xm,    Mm^Xm,    Mm^Xm
    Mm^Xm,    Mm^Xm,       Mm,       Hh,       Rr,       Rd,       Rd,       Rd,       Rd,       Rd,       Rd,       Dd,       Ds,       Rd,       Rd,       Ds,       Ds,       Ds,       Ss,       Rd,       Rd,   Hh^Vhh,       Hh,       Mm,    Mm^Xm,    Mm^Xm,    Mm^Xm,    Mm^Xm
    Mm^Xm,    Mm^Xm,    Mm^Xm,       Mm,       Mm,       Rr,       Rr,       Rd,       Rd,       Rd,       Rd,       Rd,       Rd,       Rd,       Rd,       Rd,       Ds,       Ss,       Ss,       Re,       Rd,       Hh,       Hh,       Mm,       Mm,       Mm,    Mm^Xm,    Mm^Xm
    Mm^Xm,    Mm^Xm,    Mm^Xm,       Mm,       Mm,       Hh,       Rr,       Rd,       Rd,       Rd,       Rd,       Rd,       Ss,       Rd,       Rd,       Rd,       Ww,       Ww,       Ww,       Re,       Re,       Rd,       Rd,       Rd,       Mm,       Mm,    Mm^Xm,    Mm^Xm
    Mm^Xm,    Mm^Xm,       Mm,       Mm,       Mm,       Hh,       Hh,       Rr,       Rd,       Rd,       Rd,       Ss,       Rd,       Rd,       Rd,       Ai,       Ai,       Ww,       Ww,       Re,       Re,       Rd,       Hh,       Rd,       Mm,       Mm,    Mm^Xm,    Mm^Xm
    Mm^Xm,    Mm^Xm,       Mm,       Mm,       Mm,       Hh,       Hh,       Rr,       Rr,       Ds,       Rr,   Ss^Vhs,       Rd,       Rd,       Rd,       Aa,       Ai,       Ww,       Mm,       Re,       Re,       Rd,       Hh,       Hh,       Mm,       Mm,    Mm^Xm,    Mm^Xm
    Mm^Xm,    Mm^Xm,       Mm,       Mm,       Hh,       Hh,       Hh,       Hh,       Rd,       Rr,       Ds,       Rr,       Rr,       Rd,       Rd,       Rd,       Hh,       Hh,       Mm,       Hh,       Hd,       Hh,       Hh,       Mm,       Mm,       Mm,    Mm^Xm,    Mm^Xm
    Mm^Xm,    Mm^Xm,       Mm,       Hh,       Mm,       Hh,       Hh,       Hh,       Rd,       Rd,       Rd,       Ds,       Ss,       Rr,       Rr,       Rd,       Aa,       Aa,       Rd,       Rd,       Ds,       Hd,       Ds,       Mm,       Mm,       Mm,    Mm^Xm,    Mm^Xm
    Mm^Xm,    Mm^Xm,    Mm^Xm,       Mm,       Mm,       Mm,       Hh,       Hh,       Rd,       Rd,       Rd,       Rd,       Ss,       Ss,       Rr,       Rd,       Aa,       Rd,       Rd,       Ds,       Ds,       Ds,       Hd,       Mm,       Mm,       Mm,    Mm^Xm,    Mm^Xm
    Mm^Xm,    Mm^Xm,    Mm^Xm,       Mm,       Mm,       Mm,       Hh,       Hh,       Rd,       Rd,       Rd,       Rd,       Ss,       Rd,       Ww,       Rr,       Rr,       Rd,       Rd,       Ds,       Ds,       Dd,       Hd,       Mm,       Mm,       Mm,    Mm^Xm,    Mm^Xm
    Mm^Xm,    Mm^Xm,    Mm^Xm,    Mm^Xm,       Mm,       Hh,       Hh,       Hh,       Rd,       Rd,       Rd,       Rd,       Rd,       Rd,       Rd,       Rd,       Rd,       Rr,       Rr,       Rd,       Ds,       Dd,       Rd,       Hh,       Hh,       Mm,    Mm^Xm,    Mm^Xm
    Mm^Xm,    Mm^Xm,    Mm^Xm,       Mm,       Mm,       Mm,       Hh,       Rd,       Ss,       Ss,       Dd,       Rd,       Rd,       Rd,   Ss^Vhs,       Rd,       Rd,       Gg,       Rr,       Rd,       Rd,       Rd,       Rd,       Hh,       Hh,       Mm,    Mm^Xm,    Mm^Xm
    Mm^Xm,    Mm^Xm,    Mm^Xm,       Mm,       Mm,       Mm,       Rd,       Rd,       Rd,       Dd,       Hd,       Rd,       Rd,       Rd,       Ss,       Rd,       Rd,       Rd,       Rr,    Gg^Vh,       Rd,       Rd,       Rd,       Hh,       Mm,       Mm,    Mm^Xm,    Mm^Xm
    Mm^Xm,    Mm^Xm,    Mm^Xm,       Mm,       Mm,       Mm,       Rd,       Rd,       Rd,       Hd,       Hh,       Dd,       Rd,       Ds,       Ds,       Ds,       Ds,       Rd,       Rr,       Rd,       Rd,       Rd,       Hh,       Hh,       Mm,       Mm,    Mm^Xm,    Mm^Xm
    Mm^Xm,    Mm^Xm,    Mm^Xm,    Mm^Xm,       Mm,       Rd,       Rd,       Ds,       Rd,   Dd^Vda,       Hh,       Rd,       Ds,       Ds,       Ds,       Ss,       Ds,       Rr,       Rd,       Rd,       Rd,       Hh,       Hh,       Mm,       Mm,       Mm,    Mm^Xm,    Mm^Xm
    Mm^Xm,    Mm^Xm,    Mm^Xm,       Mm,    Mm^Xm,       Mm,       Rd,       Rd,       Rd,       Rd,       Rd,       Rd,       Rd,       Rd,       Ds,       Ss,       Rr,       Rr,       Rd,       Rd,       Rd,       Hh,       Mm,       Mm,       Mm,       Mm,    Mm^Xm,    Mm^Xm
    Mm^Xm,    Mm^Xm,    Mm^Xm,    Mm^Xm,    Mm^Xm,       Mm,       Rd,       Rd,       Rd,       Ds,       Rd,       Rd,       Ce,       Rd,       Ce,       Rr,       Ce,       Rd,       Rd,       Rd,       Rd,       Hh,       Mm,       Mm,       Mm,    Mm^Xm,    Mm^Xm,    Mm^Xm
    Mm^Xm,    Mm^Xm,       Mm,       Mm,       Mm,       Rd,       Rd,       Rd,       Rd,       Rd,       Rd,       Rd,       Ce,       Ce,     1 Ke,       Ce,       Ce,       Ds,       Ds,       Rd,       Rd,       Hh,       Mm,       Mm,       Mm,    Mm^Xm,    Mm^Xm,    Mm^Xm
    Mm^Xm,    Mm^Xm,       Mm,       Hh,       Hh,       Rd,       Rd,       Rd,       Rd,       Rd,       Hh,       Hh,       Hh,       Ce,       Ce,       Ce,       Hd,       Hd,       Dd,       Gg,       Hh,       Hh,       Mm,       Mm,       Mm,    Mm^Xm,    Mm^Xm,    Mm^Xm
    Mm^Xm,    Mm^Xm,       Mm,       Hh,       Hh,       Rd,       Ds,       Ds,       Hh,       Hh,       Ds,       Ds,       Hh,       Hh,       Rr,       Rd,       Rd,       Hd,       Dd,       Gg,       Hh,       Hh,       Mm,       Mm,       Mm,    Mm^Xm,    Mm^Xm,    Mm^Xm
    Mm^Xm,    Mm^Xm,       Mm,       Hh,       Hh,       Rd,       Rd,       Gg,       Gg,       Rd,       Rd,       Rd,       Rd,       Rd,       Rr,       Ds,       Rd,       Rd,       Rd,       Hh,       Hh,       Mm,       Mm,       Mm,    Mm^Xm,       Mm,    Mm^Xm,    Mm^Xm
    Mm^Xm,    Mm^Xm,    Mm^Xm,       Mm,       Mm,       Hh,       Hh,       Gg,       Gg,       Rd,       Rd,       Rd,       Rd,       Ds,       Rr,       Ds,       Rd,       Rd,       Rd,       Rd,       Hh,       Mm,       Mm,    Mm^Xm,    Mm^Xm,    Mm^Xm,    Mm^Xm,    Mm^Xm
    Mm^Xm,    Mm^Xm,    Mm^Xm,    Mm^Xm,       Ds,       Hh,       Hh,       Rd,       Rd,       Rd,       Rd,       Rd,     3 Kh,       Rr,       Rd,       Rd,       Rd,       Rd,       Rd,       Hh,       Hh,       Mm,       Mm,       Mm,       Mm,    Mm^Xm,    Mm^Xm,    Mm^Xm
    Mm^Xm,    Mm^Xm,    Mm^Xm,    Mm^Xm,       Ds,       Hh,       Hh,       Rd,       Rd,       Rd,       Rd,       Rd,     Ch,       Rr,       Rd,       Rd,       Rd,       Rd,       Rd,       Hh,       Hh,       Mm,       Mm,       Mm,       Mm,    Mm^Xm,    Mm^Xm,    Mm^Xm
