border_size=1
usage=map

Gs^Fp       , Gs^Fp       , Hh          , Hh          , Gg          , Re          , Gg          , Gs^Fp       , Gs^Fp       , Gs^Fp       , Ds          , Gs^Fp       , Gg          , Gg          , Gg          , Gg          , Aa^Fpa      , Gs^Fp       , Gs^Fp       , Gs^Fp       , Gs^Fp       , Gs^Fp       , Gs^Fp       , Gs^Fp       , Gs^Fp       , Gs^Fp       , Gs^Fp       , Gs^Fp       , Aa          , Gg          , Gg          , Gg          
Gs^Fp       , Gs^Fp       , Hh          , Hh          , Gg          , Re          , Gg          , Gs^Fp       , Gs^Fp       , Gs^Fp       , Ds          , Gs^Fp       , Gg          , Gg          , Gg          , Gg          , Aa^Fpa      , Gs^Fp       , Gs^Fp       , Gs^Fp       , Gs^Fp       , Gs^Fp       , Gs^Fp       , Gs^Fp       , Gs^Fp       , Gs^Fp       , Gs^Fp       , Gs^Fp       , Aa          , Gg          , Gg          , Gg          
Gg          , Gg          , Hh          , Hh          , Hh          , Re          , Gg          , Gs^Fp       , Gs^Fp       , Ss          , Ds          , Gs^Fp       , Ds          , Gg          , Hh          , Hh          , Aa          , Ha          , Aa^Fpa      , Gs^Fp       , Aa^Fpa      , Gs^Fp       , Ce          , Ce          , Ce          , Gs^Fp       , Gs^Fp       , Hh          , Ha          , Gg          , Gg          , Gg          
Gg          , Gg          , Gg          , Hh          , Gg          , Re          , Gg          , Gs^Fp       , Gg          , Gs^Fp       , Gs^Fp       , Ds          , Ds          , Ds          , Hh          , Hh          , Aa          , Aa          , Ha          , Aa^Fpa      , Gs^Fp       , Gs^Fp       , Ce          , 3 Ke        , Ce          , Gs^Fp       , Ss          , Ss          , Gg          , Gg          , Gg          , Gg          
Gg          , Gg^Vh       , Gg          , Gg          , Gg          , Re          , Re          , Gs^Fp       , Hh^Fp       , Gs^Fp       , Gs^Fp       , Gs^Fp       , Ds          , Hhd         , Hhd         , Aa          , Aa          , Aa          , Aa          , Gg          , Gs^Fp       , Gs^Fp       , Gs^Fp       , Ce          , Gs^Fp       , Gs^Fp       , Gs^Fp       , Hh          , Gg^Vh       , Gg          , Gg          , Gg          
Gg          , Gg          , Gg          , Gg          , Gg          , Gg          , Hh^Vhh      , Re          , Hh^Fp       , Ds          , Ds          , Ss^Vhs      , Ss          , Wwrg        , Ww          , Ww          , Ds          , Aa          , Aa          , Hh^Vhh      , Gs^Fp       , Gs^Fp       , Gs^Fp       , Gs^Fp       , Gs^Fp       , Gs^Fp       , Gg          , Hh          , Gg          , Gg          , Gg          , Gg          
Aa          , Aa          , Aa          , Gg          , Hh          , Hh          , Re          , Re          , Ds          , Ds          , Ss          , Ss          , Ss          , Ww          , Wo          , Ww          , Wwrg        , Ds          , Hh^Fp       , Hh^Fp       , Gs^Fp       , Gs^Fp       , Ss          , Gs^Fp       , Ss          , Ss          , Hh          , Gs^Fp       , Gg^Ve       , Gs^Fp       , Gs^Fp       , Gs^Fp       
Aa          , Aa          , Aa          , Gg          , Hh          , Hh          , Re          , Ds          , Ds          , Ds          , Ss          , Ss          , Ss          , Ss          , Ss          , Ww          , Wwrg        , Wwrg        , Hh^Fp       , Hh^Fp       , Gg          , Gg          , Ss          , Gg          , Gg          , Ss          , Hh          , Gs^Fp       , Gs^Fp       , Gs^Fp       , Ds          , Ds          
Gg          , Gg          , Gg          , Gg          , Hhd         , Hhd         , Re          , Hh^Fp       , Hh^Fp       , Gs^Fp       , Ds          , Re          , Hd          , Ds          , Ss          , Ss          , Ds          , Ds          , Gg          , Gs^Fp       , Hh          , Ss          , Ss          , Ss          , Ss          , Ss          , Gg          , Gg          , Gs^Fp       , Ds          , Ds          , Ds          
Gg          , Gg          , Gg          , Re          , Ss          , Ds          , Ss          , Gs^Fp       , Gs^Fp       , Gg          , Ss          , Ss          , Ss          , Ss          , Ds          , Ss          , Ss          , Gg          , Gg          , Hh          , Ss          , Ss          , Ss          , Ss          , Ss^Vhs      , Wwrg        , Gg          , Gg          , Ww          , Ds          , Wo          , Wo          
Re          , Re          , Re          , Re          , Ss          , Ss          , Ss          , Ss          , Ss          , Gg          , Ss          , Hh^Fp       , Hh^Fp       , Hh          , Re          , Ds          , Ss          , Ss          , Ss^Vhs      , Hh          , Ss          , Ss          , Ss          , Ww          , Ww          , Ww          , Ai          , Gg          , Ww          , Ww          , Ds          , Ds          
Re          , Re          , Gg          , Gg          , Ss          , Ss          , Ss          , Ss^Vhs      , Ss          , Ss          , Ss          , Ss          , Hh^Fp       , Gs^Fp       , Re          , Ss          , Gg          , Ss          , Ss          , Ss          , Ss          , Ss          , Wwrg        , Wwrg        , Ww          , Ww          , Ai          , Ai          , Ww          , Gg          , Gg          , Gg          
Re          , Re          , Gg          , Hh          , Aa          , Ss          , Gg          , Ss          , Hh          , Gg          , Ss          , Ss          , Hh^Fp       , Gs^Fp       , Gs^Fp       , Gs^Fp       , Gs^Fp       , Gs^Fp       , Ss          , Ss          , Ss          , Ss          , Wwrg        , Ww          , Ww          , Ww          , Ai          , Ai          , Ww          , Gg          , Gg          , Gg          
Ss          , Ss          , Ss          , Hh          , Ss          , Hh          , Hh          , Hh          , Hh          , Ds          , Gg          , Ss          , Ss          , Gg          , Ss          , Gs^Fp       , Hh          , Ss          , Gg          , Hh          , Hh          , Hh          , Ss          , Ww          , Ww          , Ww          , Ww          , Ww          , Gg          , Aa          , Aa          , Aa          
Ss          , Ss          , Ss          , Ss          , Ss          , Hh          , Hh          , Hh          , Ss          , Re          , Aa          , Hh          , Ss          , Ss          , Gg          , Hh^Fp       , Hh^Vhh      , Ss          , Gs^Fp       , Mm          , Mm          , Hh          , Hh          , Ss          , Ss          , Ww          , Gg          , Ww          , Gg          , Gg          , Gg          , Gg          
Ss          , Ss          , Ss          , Ss          , Ss          , Gg          , Ss          , Ss          , Chs         , Ds          , Ds          , Hh          , Ss          , Ss          , Ss          , Hh^Fp       , Gs^Fp       , Gs^Fp       , Hh          , Hh          , Hh          , Mm          , Hh          , Hh          , Gs^Fp       , Ss          , Gg          , Ss          , Gg          , Gg^Vh       , Gg          , Gg          
Gg          , Gg          , Gg          , Gg          , Ss          , Ss          , Ss          , Chs         , 2 Kh        , Chs         , Gg          , Re          , Re          , Ss          , Gg          , Ss          , Ss          , Gg          , Gg          , Hh          , Hh          , Hh          , Hh          , Gs^Fp       , Ss^Vhs      , Ss          , Ss          , Ss          , Gg          , Gg          , Gg          , Gg          
Gg          , Gg          , Hh          , Gg          , Ss          , Ss          , Ss          , Chs         , Chs         , Chs         , Ss^Vhs      , Ds          , Gg          , Ss          , Hh          , Ss          , Ss          , Gg          , Ss          , Ss^Vhs      , Gg          , Hh          , Gs^Fp       , Gs^Fp       , Gs^Fp       , Ss          , Ss          , Ss          , Ss          , Gg          , Gg          , Gg          
Gg          , Gg          , Hh          , Ss          , Ss          , Hh          , Hh          , Ss          , Gs^Fp       , Gs^Fp       , Ss          , Ds          , Ss          , Hh          , Hh          , Hh          , Ss          , Ss          , Ss          , Ss          , Ss          , Hh          , Hh^Fp       , Gs^Fp       , Ss          , Ss          , Ss          , Ss          , Ss          , Gg          , Gg          , Gg          
Gg          , Gg          , Ss          , Ss          , Ss          , Ss          , Ss          , Gs^Fp       , Hh          , Ss          , Ss          , Ss          , Rb          , Ss          , Hh          , Ss          , Ss          , Gg          , Gg          , Ss          , Ss          , Ss          , Ss          , Gg          , Ww          , Ss          , Ss          , Ss          , Ss          , Gg          , Gg          , Gg          
Gg          , Gg          , Ss          , Ss          , Re          , Ds          , Ss          , Gs^Fp       , Hh          , Hh          , Ss          , Wwrg        , Ss          , Ss          , Ss          , Ss          , Wwrg        , Hh^Fp       , Gg          , Gg          , Ss          , Ss          , Wwrg        , Ww          , Gg          , Ss          , Ss          , Ss          , Ss          , Gg          , Gg          , Gg          
Gg          , Gg          , Ss          , Ss          , Re          , Ds          , Hh          , Mm          , Hh          , Gg          , Ss          , Ss          , Re          , Ss          , Ww          , Ww          , Wwrg        , Ss          , Ss          , Ss          , Ss          , Wwrg        , Gg          , Gg          , Gg          , Gg          , Gg          , Gg          , Gg          , Gg          , Aa          , Aa          
Gs^Fp       , Gs^Fp       , Gs^Fp       , Ss          , Ss          , Ss          , Ss          , Hh          , Hd          , Ds          , Ss          , Re          , Wwrg        , Ww          , Re          , Gs^Fp       , Gs^Fp       , Ss^Vhs      , Ss          , Ss          , Gg          , Gg          , Gg          , Hh^Fp       , Hh          , Gg          , Gg          , Gg          , Gg          , Gg          , Gg          , Gg          
Gs^Fp       , Ss          , Ss          , Ss          , Ss          , Ss          , Ds          , Hhd         , Hh          , Gg          , Ss          , Ss^Vhs      , Gg          , Gg          , Re          , Gg          , Hh          , Gs^Fp       , Hh          , Hh          , Ss          , Gg          , Gs^Fp       , Gs^Fp       , Gg          , Gs^Fp       , Gs^Fp       , Gs^Fp       , Gs^Fp       , Gs^Fp       , Gs^Fp       , Gs^Fp       
Ds          , Ds          , Ss          , Gg          , Gg          , Rb          , Ss          , Ds          , Gg          , Ss          , Ww          , Ss          , Ss^Vhs      , Ds          , Ds          , Gs^Fp       , Hh          , Hh          , Hh          , Hh          , Ss          , Hh          , Hh          , Mm          , Mm          , Hh          , Hh          , Gg          , Gg          , Gg          , Ss          , Ss          
Ds          , Ds          , Ds          , Gg          , Ds          , Ss          , Ss          , Ss          , Ss          , Ss          , Ww          , Ss          , Ss          , Re          , Re          , Gs^Fp       , Hh          , Hh          , Hh          , Gg          , Ss          , Ss          , Hh          , Mm          , Mm          , Hh          , Ss^Vhs      , Gg          , Gg          , Gg          , Gg          , Gg          
Ds          , Ds          , Gg          , Gg          , Ds          , Ss          , Gs^Fp       , Hh^Fp       , Ss          , Ww          , Ww          , Ww          , Ss          , Ds          , Gg          , Ss          , Ss          , Ss          , Hh          , Hh          , Ds          , Ss          , Hh          , Hh          , Hh          , Hh          , Ss          , Gg          , Gg          , Gg          , Gg          , Gg          
Gs^Fp       , Gs^Fp       , Gg^Ve       , Gs^Fp       , Gg          , Ss          , Gs^Fp       , Hh^Fp       , Hh^Fp       , Wwrg        , Wwrg        , Ww          , Ss          , Hh^Fp       , Ds          , Ss          , Ss          , Ss          , Ss          , Hh          , Re          , Ss          , Re          , Hh^Vhh      , Ds          , Hh          , Ss          , Ss          , Ss          , Gs^Fp       , Gs^Fp       , Gs^Fp       
Gs^Fp       , Gs^Fp       , Gs^Fp       , Gs^Fp       , Ss          , Ss          , Re          , Gg          , Ss^Vhs      , Wwrg        , Ss          , Ss          , Ss          , Hh^Fp       , Gg          , Ss          , Ss          , Gg          , Ss          , Ss          , Hhd         , Ss          , Ss          , Gg          , Ds          , Re          , Ss          , Ss          , Ss          , Hh          , Hh          , Hh          
Ss          , Ss          , Ds          , Ds          , Ss          , Gg          , Ds          , Gg          , Gg          , Ss          , Ss          , Gg          , Ss          , Ss          , Ss          , Ss          , Gg          , Gs^Fp       , Hh^Fp       , Hh^Fp       , Hh^Fp       , Gg          , Gg          , Ss          , Ss          , Ss          , Ss          , Ss          , Ss          , Mm          , Mm          , Mm          
Ss          , Ss          , Ds          , Ds          , Ss          , Gs^Fp       , Ds          , Gg          , Ss          , Ss          , Gg          , Ds          , Gg          , Ss          , Ss          , Ss          , Ss^Vhs      , Gg          , Gg          , Gg          , Ss          , Gs^Fp       , Ss          , Ss          , Ss          , Ss          , Gg          , Ss          , Mm          , Mm          , Mm          , Mm          
Gs^Fp       , Gs^Fp       , Ds          , Ss          , Ss          , Gs^Fp       , Ss          , Ss^Vhs      , Ss          , Ss          , Ss          , Ds          , Ww          , Ss          , Ss          , Ss          , Ss          , Ss          , Ss          , Gg          , Gg          , Gg          , Gg          , Gg          , Ss          , Gg          , Ds          , Ds          , Hh          , Mm          , Mm          , Mm          
Re          , Re          , Ss          , Ss          , Ss          , Ss          , Re          , Gg          , Gg          , Ss          , Gg          , Ds          , Ss          , Ss          , Ss          , Ss          , Re          , Gg          , Ds          , Gs^Fp       , Gs^Fp       , Ss          , Ss          , Ss          , Ss^Vhs      , Ss          , Ss          , Ss          , Ss          , Hh          , Mm          , Mm          
Gs^Fp       , Gs^Fp       , Ss          , Ss          , Ss          , Re          , Gg          , Aa          , Gg          , Gg          , Gg          , Gg          , Gg          , Ss^Vhs      , Gg          , Re          , Ce          , Re          , Ds          , Ss          , Ds          , Ss          , Ss          , Gs^Fp       , Gs^Fp       , Ss          , Ss          , Ss          , Ss          , Hh          , Hh          , Hh          
Ss          , Gs^Fp       , Ss          , Ss          , Ss          , Gg          , Rb          , Aa          , Rb          , Rb          , Rb          , Aa          , Rb          , Gg          , Rb          , Ce          , 1 Ke        , Ce          , Rb          , Ds          , Gd^Vo       , Gg          , Gg          , Gg          , Gg          , Gg          , Ss          , Ss          , Ss          , Gg          , Aa          , Aa          
Ss          , Ss          , Rb          , Rb          , Ss          , Rb          , Gg          , Aa          , Gg          , Aa          , Aa          , Aa          , Gg          , Rb          , Re          , Ce          , Ce          , Ce          , Ss          , Rb          , Rb          , Rb          , Rb          , Gg          , Rb          , Gg          , Rb          , Rb          , Rb          , Gg          , Aa          , Aa          
Gg          , Ss          , Gg          , Hh          , Hh          , Hh          , Ha          , Aa          , Aa          , Aa          , Aa          , Aa          , Gg          , Gg          , Gg          , Re          , Re          , Re          , Ds          , Ds          , Gg          , Gg          , Gg          , Rb          , Gg          , Rb          , Gg          , Ds          , Ds          , Rb          , Rb          , Rb          
Gg          , Gg          , Gg          , Hh          , Hh          , Hh          , Ha          , Aa          , Aa          , Aa          , Aa          , Aa          , Gg          , Gg          , Gg          , Re          , Re          , Re          , Ds          , Ds          , Gg          , Gg          , Gg          , Gg          , Gg          , Gg          , Gg          , Ds          , Ds          , Ds          , Gg          , Gg          
