border_size=1
usage=map

Gg          , Gg          , Gg          , Gg          , Gs^Fp       , Gs^Fp       , Gs^Fp       , Gs^Fp       , Rb          , Gs^Fp       , Gg          , Gg          , Gg          , Gg          , Gg          , Gg          , Ww          , Hh          , Gg          , Gg          , Gg          , Gg          , Gg          , Gg          , Gg          , Gg          , Gg          , Gg          , Aa          , Ds          , Ds          , Gg          , Gg          , Gg          , Aa          , Ha          , Gg          , Gs^Fp       , Gs^Fp       , Gs^Fp       , Gs^Fp       , Gs^Fp       
Gg          , Gg          , Gg          , Gg          , Gg          , Gg^Ve       , Gs^Fp       , Gs^Fp       , Rb          , Gs^Fp       , Gg          , Gg          , Gg          , Gg          , Gs^Fp       , Hh          , Ww          , Hh          , Hh          , Hh          , Gg          , Gg          , Gg          , Gg          , Gg          , Gg          , Gg          , Gg          , Gg          , Ds          , Gg          , Gg          , Gg          , Gg          , Aa          , Aa          , Gg          , Gg          , Gs^Fp       , Gg^Ve       , Gs^Fp       , Gs^Fp       
Gg          , Gg          , Gg          , Gs^Fp       , Gg          , Gs^Fp       , Rb          , Rb          , Gs^Fp       , Gs^Fp       , Gs^Fp       , Gg          , Gg          , Gs^Fp       , Gs^Fp       , Hh          , Ww          , Hh          , Hh          , Hh          , Gg          , Gg          , Hh          , Gg          , Ce          , Ce          , Ce          , Gg          , Gg          , Gg          , Gg          , Gg          , Gg          , Gg          , Gg          , Gg          , Gg          , Gg          , Gg          , Gg          , Gg          , Gg          
Gg          , Gg          , Gg          , Gs^Fp       , Ce          , Ce          , Ce          , Gs^Fp       , Gs^Fp       , Gg^Ve       , Gs^Fp       , Gs^Fp       , Gs          , Gs          , Ww          , Ww          , Ww          , Mm          , Hh          , Ha          , Gg          , Hh          , Hh          , Hh          , Ce          , 4 Ke        , Ce          , Gg          , Gg          , Gg          , Gg          , Gg          , Gg          , Gg          , Gg          , Gll^Fp      , Ce          , Gll^Fp      , Gg          , Gg          , Gg          , Gg          
Gg          , Gs^Fp       , Gs^Fp       , Rb          , Ce          , 3 Ke        , Ce          , Rb          , Rb          , Gs^Fp       , Gs^Fp       , Gs^Fp       , Ww          , Wwf         , Gs          , Ww          , Mm^Vhh      , Hh          , Hh          , Hh          , Hh          , Hh          , Hh          , Hh          , Gg          , Ce          , Gg^Vh       , Gg          , Gg          , Gg          , Gg          , Gg          , Gg          , Gg          , Gg          , Ce          , 5 Ke        , Ce          , Gg          , Gg          , Gg          , Gg          
Gg          , Gs^Fp       , Rb          , Gll^Fp      , Gll^Fp      , Ce          , Hh          , Hh          , Gs^Fp       , Rb          , Gs^Fp       , Ss          , Ww          , Gs          , Gs          , Ww          , Ww          , Ww          , Ww          , Ww          , Ww          , Ww          , Ww          , Gg          , Gg          , Gg          , Gg          , Gg          , Gg          , Gg          , Gg          , Gg          , Gg          , Gg          , Gll^Fp      , Ce          , Ce          , Ce          , Gg          , Gg          , Gg          , Gg          
Hh          , Gs^Fp       , Rb          , Gs^Fp       , Gs^Fp       , Gs^Fp       , Hh          , Hh          , Gg          , Rb          , Rb          , Ss          , Ss          , Ww          , Ww          , Ww          , Gs          , Hh          , Hh          , Gs^Fp       , Gs^Fp       , Gs^Fp       , Gs^Fp       , Ww          , Ww          , Gg          , Ai          , Aa          , Aa          , Gg          , Aa          , Gg          , Gg          , Gg          , Gg          , Rb          , Gs^Fp       , Gs^Fp       , Gg          , Gg          , Gg          , Gg          
Hh          , Gg          , Rb          , Gg          , Gs^Fp       , Gs^Fp       , Gs^Fp       , Gg          , Gg          , Gs^Fp       , Gs^Fp       , Rb          , Rb          , Ss          , Ww          , Ww          , Gs          , Hh          , Gs^Fp       , Gg          , Gg          , Gg^Ve       , Gs^Fp       , Gg          , Gg          , Ww          , Gg          , Ai          , Aa          , Aa          , Aa          , Gg          , Gg          , Gg          , Wwg         , Rb          , Rb          , Gg^Vh       , Wwg         , Gg          , Wwg         , Wwg         
Hh          , Gg          , Rb          , Gg          , Gg          , Gg^Ve       , Gs^Fp       , Gg          , Gg          , Gs^Fp       , Gs^Fp       , Gg          , Rb          , Hh          , Mm          , Mm          , Hh          , Hh          , Gg          , Gg          , Gg          , Gs^Fp       , Gs^Fp       , Gg          , Gg          , Gg          , Aa          , Ai          , Ai          , Aa          , Aa          , Gg          , Wwg         , Wwg         , Gg          , Ww^Vm       , Wwg         , Wwf         , Rb          , Wwg         , Gg          , Wwg         
Gg          , Gg          , Rb          , Gg          , Gg          , Gs^Fp       , Gs^Fp       , Gs^Fp       , Gs^Fp       , Gs^Fp       , Gs^Fp       , Gs^Fp       , Gs^Fp       , Rb          , Hh          , Mm          , Mm          , Hh          , Gg          , Gg          , Ds          , Ss          , Ss          , Gs^Fp       , Gs^Fp       , Gg          , Gg          , Aa          , Aa          , Ai          , Aa          , Gg          , Wwg         , Hh          , Hh          , Hh          , Gg          , Gg          , Gg          , Rb          , Rb          , Gs^Fp       
Rb          , Rb          , Gg          , Aa          , Gg          , Gg          , Gs^Fp       , Gs^Fp       , Gs^Fp       , Gg^Ve       , Gs^Fp       , Gg          , Gs^Fp       , Rb          , Hh          , Mm          , Mm          , Hh          , Gg          , Gg          , Ss          , Ss          , Gs^Fp       , Gs^Fp       , Gs^Fp       , Gg          , Gg          , Aa          , Aa          , Ai          , Wwg         , Wwg         , Gg          , Hh          , Mm          , Mm          , Hh          , Gg          , Gg          , Gg          , Rb          , Gs^Fp       
Aa          , Aa          , Aa          , Ss          , Ss          , Ss          , Gg          , Gg          , Gg          , Gs^Fp       , Gs^Fp       , Ss          , Gg          , Rb          , Hh          , Mm          , Mm          , Hh          , Gg          , Gg          , Ss          , Ss          , Gg          , Gg          , Gg          , Gg          , Gg          , Gg          , Ww          , Ww          , Gg          , Hh          , Gg          , Hh          , Hh          , Hh          , Hh          , Gg          , Gg          , Rb          , Gg          , Gs^Fp       
Rr          , Ss          , Ss          , Ss          , Ss          , Ss          , Ss          , Ss          , Ss          , Gs^Fp       , Ss          , Gg          , Gg          , Rb          , Rb          , Hh          , Hh          , Hh          , Gg          , Gg          , Gg          , Gs^Fp       , Gg          , Gg          , Gg          , Gs^Fp       , Ww          , Ww          , Gg          , Gg          , Gg          , Gs^Fp       , Hh          , Gs^Fp       , Hh          , Hh          , Gg          , Gg          , Gg          , Rb          , Gg          , Gg          
Rr          , Gg          , Ss          , Ss          , Ss          , Ss          , Aa          , Ss          , Gg          , Gs^Fp       , Gs^Fp       , Gg          , Gg          , Gs^Fp       , Rb          , Hh          , Hh          , Hh          , Gg          , Gg          , Gs^Fp       , Gg^Ve       , Gs^Fp       , Gg          , Gs^Fp       , Gs^Fp       , Ww          , Gs^Fp       , Gs^Vl       , Gs^Fp       , Gg          , Gs^Fp       , Gs^Fp       , Gs^Fp       , Gs^Fp       , Gs^Fp       , Gg          , Gll^Fp      , Gll^Fp      , Rb          , Rb          , Gg          
Rr          , Gg          , Gg          , Ss          , Aa          , Aa          , Aa          , Gg          , Gg          , Gg          , Gs^Fp       , Gg^Ve       , Gs^Fp       , Gs^Fp       , Gg^Ve       , Rb          , Rb          , Gg          , Gs^Fp       , Gs^Fp       , Gs^Fp       , Gs^Fp       , Gs^Fp       , Gs^Fp       , Gs^Fp       , Gs^Fp       , Gs^Fp       , Ww          , Gs^Fp       , Gs^Fp       , Gg^Ve       , Gs^Fp       , Gg          , Gg          , Gs^Fp       , Gs^Fp       , Gg          , Gll^Fp      , Gll^Fp      , Gs^Vl       , Rb          , Gg          
Gs^Fp       , Rr          , Rr          , Gg          , Aa          , Aa          , Aa          , Aa          , Gg          , Gg          , Gg          , Gg          , Gll^Fp      , Gs^Fp       , Gs^Fp       , Gs^Fp       , Rb          , Gs^Fp       , Gs^Fp       , Gg          , Gs^Fp       , Gg          , Gg          , Gs^Fp       , Gs^Fp       , Gs^Fp       , Gg          , Ww          , Gg          , Gs^Fp       , Gs^Fp       , Gg          , Gll^Fp      , Gll^Fp      , Ss          , Gs^Fp       , Gg          , Gg          , Gg          , Rb          , Gg          , Gg          
Rr          , Gg^Vh       , Rr          , Gg          , Aa          , Aa          , Aa          , Aa          , Aa          , Gg          , Aa^Fda      , Gg          , Gll^Fp      , Gll^Fp      , Gs^Fp       , Gg^Ve       , Gg          , Rb          , Gs^Fp       , Gg          , Gg          , Gs^Fms      , Gs^Fms      , Gg          , Gs^Fp       , Gs^Fp       , Ww          , Ww          , Ss          , Gs^Fp       , Gg          , Gg          , Gll^Fp      , Gll^Fp      , Ss          , Gg          , Gs^Fp       , Gg          , Rb          , Rb          , Gg          , Gg          
Gg          , Aa          , Aa          , Aa          , Gg          , Gg          , Gg          , Gg          , Gs^Fms      , Aa^Fda      , Aa^Fda      , Gg          , Gg          , Gll^Fp      , Gll^Fp      , Gg          , Aa^Fma      , Rb          , Rb          , Gg^Vh       , Hh^Fp       , Gs^Fms      , Hh^Fp       , Gg          , Gs^Fp       , Gs^Fp       , Ww          , Gs^Fp       , Gs^Fp       , Ss          , Gg          , Gg          , Hh^Fms      , Ss          , Gg          , Gg          , Rb          , Rb          , Gg          , Gg          , Gs^Fp       , Gg          
Gg          , Rb          , Rb          , Gg          , Ss          , Gg          , Gg          , Gs^Fms      , Gs^Fms      , Aa^Fda      , Gs^Fms      , Ss          , Ss          , Gll^Fp      , Gg          , Aa^Fma      , Aa          , Gg          , Gg          , Hh^Fp       , Hh^Fp       , Hh^Fp       , Gg          , Gg          , Gs^Fp       , Gs^Fp       , Ww          , Gs^Fp       , Ww          , Ss          , Gg          , Hh^Fms      , Hh^Fms      , Hh^Fms      , Gg          , Gg          , Rb          , Gg          , Gs^Fp       , Gs^Fp       , Gs^Fp       , Gs^Fp       
Gg          , Rb          , Gg          , Rb          , Rb          , Ss          , Gg          , Gs^Fms      , Gs^Fms      , Gs^Fms      , Gg          , Ss          , Gg          , Gg          , Gg          , Aa^Fma      , Aa          , Gg          , Gg          , Hh          , Gg          , Rb          , Rb          , Gs^Fp       , Gs^Fp       , Gs^Fp       , Gs^Fp       , Ww          , Gg          , Ww          , Gg          , Hh^Fms      , Hh^Fms      , Gs^Fp       , Gs^Fp       , Gs^Fp       , Rb          , Gs^Fp       , Gs^Fp       , Gs^Fp       , Gs^Fp       , Gg          
Gg          , Rb          , Gg          , Gg          , Gs^Fp       , Rb          , Gs^Fms      , Gs^Fms      , Gs^Fms      , Gs^Fms      , Gg          , Gg          , Hh          , Hh          , Hh          , Ss          , Ss          , Gg          , Hh          , Hh          , Gg          , Gg          , Gs^Fp       , Rb          , Rb          , Gs^Fp       , Gs^Fp       , Gg          , Gs^Vl       , Ww          , Gg^Vh       , Gs^Fp       , Hh          , Hh          , Gg          , Gs^Fp       , Rb          , Gs^Fp       , Gs^Fp       , Gg^Ve       , Gs^Fp       , Gg          
Gg          , Rb          , Rb          , Gs^Fp       , Gs^Fp       , Rb          , Rb          , Gs^Fms      , Gg          , Gs^Fms      , Gg          , Gg          , Ha^Fpa      , Hh          , Hh          , Ha          , Aa          , Gg          , Gg          , Gg          , Gg          , Gs^Fp       , Gs^Fp       , Gs^Fp       , Rb          , Gs^Fp       , Gs^Fp       , Gs^Fp       , Gg          , Ww          , Hh          , Hh          , Hh          , Hh          , Gs^Fp       , Gs^Fp       , Rb          , Gg          , Gg          , Gg          , Gs^Fp       , Rb          
Gg          , Gg          , Rb          , Gs^Vl       , Gs^Fp       , Gs^Fp       , Rb          , Gg^Vh       , Gg          , Gg          , Aa          , Ha^Fpa      , Gs^Fp       , Hh          , Hh          , Ha          , Aa          , Gg          , Gg          , Gg          , Gs^Fp       , Gs^Fp       , Gs^Fp       , Gs^Fp       , Rb          , Gs^Fp       , Gs^Fp       , Gg          , Ww          , Ww          , Ss          , Ss          , Mm          , Hh          , Gs^Fp       , Gs^Fp       , Rb          , Gg          , Ss          , Gs^Fp       , Rb          , Rb          
Gg          , Gg          , Gg          , Rb          , Gs^Fms      , Gs^Fms      , Gs^Fms      , Rb          , Gg          , Aa          , Aa          , Hh          , Hh          , Hh          , Ha          , Ha          , Aa          , Gg          , Gg          , Gs^Fp       , Gs^Fp       , Gs^Vl       , Gs^Fp       , Gs^Fp       , Rb          , Gg          , Gg          , Gg^Vh       , Ww          , Ww          , Ww          , Ss          , Ww          , Hh          , Gs^Fp       , Gs^Fp       , Rb          , Ss          , Gs^Fp       , Rb          , Gs^Fp       , Gs^Fp       
Gg          , Gg          , Gg          , Rb          , Gs^Fms      , Gs^Fms      , Gg          , Rb          , Aa          , Aa          , Hh^Fp       , Hh          , Hh          , Gs^Fp       , Gs^Fp       , Gg          , Gs^Fds      , Gg          , Gs^Fds      , Gg          , Gs^Fp       , Gs^Fp       , Gs^Fp       , Gg          , Rb          , Gg          , Gg          , Aa          , Ai          , Ww          , Ww          , Ww          , Ww          , Hh          , Ww          , Gs          , Ww          , Gs^Fp       , Ww          , Rb          , Ds          , Gs^Fp       
Gg          , Gg          , Gg          , Rb          , Rb          , Gg          , Gg          , Rb          , Gll^Fp      , Gll^Fp      , Gll^Fp      , Hh^Fp       , Hh^Fp       , Gg^Ve       , Gs^Fp       , Gs^Fds      , Gs^Fds      , Gs^Fds      , Gs^Fds      , Gg          , Gs^Fp       , Gg          , Gs^Fp       , Gs^Fp       , Rb          , Gg          , Gg          , Aa          , Ai          , Ai          , Ai          , Ww          , Ww          , Ww          , Gs^Fds      , Gs^Fds      , Gs^Fds      , Ww          , Gg          , Ww^Bw|      , Ds          , Ds          
Gll         , Gll         , Gg          , Gll         , Gll         , Rb          , Rb          , Gll^Fp      , Gll^Fp      , Gll^Fp      , Gll^Fp      , Gll^Fp      , Rb          , Gs^Fp       , Gs^Fp       , Gs^Fds      , Gg          , Gs^Fds      , Gg          , Gg          , Gg          , Gs^Fp       , Gs^Fp       , Gs^Fp       , Gs^Fp       , Rb          , Gg^Fet      , Gg^Fet      , Gg^Fet      , Gg          , Ai          , Ww          , Rb          , Rb          , Gs^Fds      , Gs^Fds      , Gs^Fds      , Gs^Fds      , Gg          , Ww^Bw|      , Wo          , Ww          
Gll         , Gll         , Gll         , 2 Gll       , Gll         , Gll^Fp      , Gll^Fp      , Rb          , Gll^Fp      , Gll^Fp      , Gll^Fp      , Gg          , Gg          , Rb          , Rb          , Rb          , Rb          , Rb          , Rb          , Gg          , Gg          , Gs^Fp       , Gs^Fp       , Gs^Fp       , Gs^Fp       , Gs^Fp       , Gg^Fet      , Gll^Fp      , Gll^Fp      , Gg^Fet      , Gg^Fet      , Ww          , Gs^Fp       , Gs          , Gs          , Gs^Fds      , Rb          , Gs^Fds      , Gg          , Rb          , Ds          , Ds          
Gs^Fp       , Gll         , Gll         , 1 Gll       , Gll         , Gll^Fp      , Gll^Fp      , Rb          , Rb          , Gg          , Gg          , Rb          , Rb          , Gg          , Gg          , Gg          , Gg          , Ds          , Gg          , Rb          , Rb          , Gs^Fp       , Rb          , Gg          , Gg          , Gs^Fp       , Gg^Fet      , Gll^Fp      , Gll^Fp      , Gll^Fp      , Gg^Fet      , Ww          , Rb          , Rb          , Rb          , Rb          , Gs^Fp       , Gg          , Gg          , Rb          , Gg          , Ds          
Gg          , Gll         , Gll         , Wo          , Gll         , Gll         , Gg          , Gll^Fp      , Gs^Vl       , Rb          , Rb          , Gg          , Gg          , Rb          , Gg          , Gg          , Ds          , Ds          , Ds          , Gg          , Gg          , Rb          , Gs^Fp       , Rb          , Rb          , Rb          , Gs^Fp       , Gg^Fet      , Gll^Fp      , Gg^Fet      , Rb          , Wwf         , Gs^Fp       , Gg^Ve       , Gs^Fp       , Gs^Fp       , Gs^Fp       , Gg          , Rb          , Rb          , Gg          , Aa          
Gg          , Gg          , Gll         , Gll         , Gll         , Gll         , Gg          , Gg          , Gg          , Gg          , Gg          , Rb          , Rb          , Rb          , Rb          , Rb          , Rb          , Ds          , Rb          , Gg          , Gg          , Gg          , Gs^Fp       , Gs^Fp       , Rb          , Rb          , Rb          , Gg^Fet      , Gg^Fet      , Gg^Fet      , Rb          , Ww          , Rb          , Gs^Fp       , Gs^Fp       , Gs^Fp       , Rb          , Rb          , Gg^Vh       , Gg          , Gg          , Gg          
Gg          , Gg          , Gll         , Aa          , Aa          , Aa          , Aa          , Aa          , Aa          , Aa          , Aa          , Aa          , Aa          , Rb          , Rb          , Gg          , Gg          , Rb          , Gg          , Rb          , Rb          , Rb          , Rb          , Rb          , Gs^Fp       , Gs^Fp       , Rb          , Gs^Fp       , Gs^Fp       , Rb          , Rb          , Ww          , Gs^Fp       , Rb          , Rb          , Rb          , Gg          , Gg          , Rr          , Rr          , Gg          , Gg          
