border_size=1
usage=map

Gs^Fp       , Gs^Fp       , Ss          , Ss          , Ss          , Ss          , Gs^Fp       , Ds          , Gs^Fp       , Gg          , Gg          , Gs          , Gs          , Gs          , Gs          , Gs          , Gs          , Gs          , Gs          , Gs          , Gs          , Gg          , Gg          , Gg          , Gg          , Gg          , Gg          , Gs^Fp       , Gs^Fp       , Hh          , Hh          , Hh          , Mm          , Mm          , Gg          , Gg          , Gg          , Gs          , Gs          , Gs          , Gs^Fp       , Gs^Fp       , Re          , Re          , Gs          , Gg          , Gs          , Gs          , Gs          , Gs          , Gg          , Gg          , Gg          , Gg          , Ss          , Ss          , Ss          , Ss          , Gg          , Gg          , Re          , Re          
Gs^Fp       , Gs^Fp       , Ss          , Ss          , Ss          , Ss          , Gs^Fp       , Ds          , Gs^Fp       , Gg          , Gg          , Gs          , Gs          , Gs          , Gs          , Gs          , Gs          , Gs          , Gs          , Gs          , Gs          , Gg          , Gg^Ve       , Gg          , Gg          , Gg          , Gg          , Gs^Fp       , Gs^Fp       , Hh          , Hh          , Hh          , Mm          , Mm          , Gg          , Gg          , Gg^Vh       , Gs          , Gs          , Gs          , Gs^Fp       , Gs^Fp       , Re          , Re          , Gs          , Gg^Vh       , Gs          , Gs          , Gs          , Gs          , Gg          , Gg          , Gg          , Gg          , Ss          , Ss          , Ss          , Ss          , Gg          , Gg          , Re          , Re          
Gs^Fp       , Gs^Fp       , Gs^Fp       , Ss          , Gs^Fp       , Ss          , Gs^Fp       , Gg^Ve       , Gg          , Gg          , Gs          , Gs          , Gs          , Gs          , Gs          , Gs          , Gs          , Gs          , Gs          , Gs          , Gs          , Gg          , Gg          , Gg          , Gg          , Gg          , Gg          , Gs^Fp       , Gs^Fp       , Gg          , Hh          , Hh          , Hh          , Hh          , Gs          , Gg          , Ce          , Gs          , Gs          , Gs          , Re          , Re          , Re          , Gs          , Re          , Gs          , Re          , Gs          , Gs          , Gs          , Gg          , Gg          , Gg          , Gg          , Ss          , Ss          , Gs          , Gs          , Gs          , Re          , Gg          , Gg          
Gs^Fp       , Gs^Fp       , Gs^Fp       , Gg^Ve       , Gs^Fp       , Ww          , Gg          , Gg          , Gg          , Gs          , Gs          , Gs          , Gs          , Gs          , Gs          , Gs          , Gg^Vh       , Re          , Gs          , Gs          , Gs          , Gs^Fp       , Gs          , Gs          , Gs          , Gg          , Gg          , Gg^Ve       , Gs^Fp       , Hh          , Hh          , Hh          , Hh          , Gs          , Gs          , Ce          , 3 Ke        , Ce          , Gs^Fp       , Re          , Gs^Fp       , Gg          , Gg          , Gs          , Gs          , Re          , Gs          , Re          , Re          , Gg          , Gg          , Gg          , Gg          , Gg          , Gs^Fp       , Gs^Fp       , Gs          , Gs          , Gs          , Gg          , Gg          , Gg          
Gs^Fp       , Gs^Fp       , Gg          , Gg          , Gg          , Ww          , Ww          , Gg          , Gg          , Gs          , Gs          , Gs          , Gs          , Gs          , Gs          , Gs          , Gg          , Re          , Re          , Gg          , Gg          , Gs^Fp       , Gs          , Gs          , Gs          , Gs^Fp       , Gg          , Gs^Fp       , Gg          , Gs^Fp       , Gg          , Gg          , Gg          , Gs          , Gs          , Ce          , Ce          , Ce          , Gg          , Gs^Fp       , Gg          , Gg          , Gg          , Gg          , Gg          , Gs          , Gg          , Gg          , Gg          , Re          , Re          , Gg          , Gg          , Gg^Ve       , Re          , Re          , Gs          , Gs          , Gs          , Gg          , Gg          , Gg          
Gs^Fp       , Gs^Fp       , Gs^Fp       , Gs^Fp       , Gs^Fp       , Gs^Fp       , Gs^Fp       , Ww          , Gs          , Gs          , Gs          , Gs          , Gs          , Gs          , Gs          , Gg          , Gg          , Gg          , Re          , Gg          , Gg          , Gs^Fp       , Gs          , Gs          , Gs          , Gs^Fp       , Gg          , Gg          , Gg          , Gg          , Gg          , Gg          , Gg          , Gg          , Re          , Re          , Gg          , Gg          , Gg          , Gg          , Gg          , Gg          , Gs^Fp       , Gg          , Gg          , Gg          , Gg          , Gg          , Gg          , Gg          , Gg          , Re          , Re          , Re          , Gg          , Gg          , Gs          , Gs          , Re          , Gg          , Gg          , Gg          
Gs^Fp       , Gs^Fp       , Gs^Fp       , Gs^Fp       , Gs^Fp       , Gs^Fp       , Gs^Fp       , Ww          , Ww          , Gs          , Gs          , Gg          , Gg          , Gg          , Gg          , Gg          , Gg          , Gg          , Gg          , Re          , Re          , Gs^Fp       , Re          , Gs          , Gg          , Gg          , Gg          , Gg          , Re          , Gg          , Gg          , Gg          , Re          , Re          , Gs          , Gg          , Gg          , Gg          , Gs^Fp       , Gg          , Gg^Ve       , Gs^Fp       , Gs^Fp       , Gg          , Gg          , Gg          , Gg          , Gg          , Gg          , Gg          , Gg          , Gg          , Gs^Fp       , Re          , Gg          , Gs          , Gs          , Gs          , Re          , Gg          , Re          , Re          
Gs^Fp       , Gs^Fp       , Gs^Fp       , Gs^Fp       , Gs^Fp       , Gs^Fp       , Gs^Fp       , Gg^Vh       , Gg          , Ww          , Ww          , Ww          , Ww          , Gg^Ve       , Ww          , Ww          , Ww          , Gg          , Gg          , Gg          , Gg          , Gg^Vh       , Re          , Gg          , Gg          , Gg          , Re          , Re          , Gg          , Re          , Re          , Re          , Gg          , Gs          , Gs          , Gs          , Gg          , Gg          , Gs^Fp       , Gs^Fp       , Gs^Fp       , Gs^Fp       , Hh          , Hh          , Hh          , Gg          , Gg          , Gg          , Gg          , Gg          , Gg          , Gg          , Gs^Fp       , Re          , Re          , Gs          , Re          , Re          , Gg          , Re          , Gg          , Gg          
Gs^Fp       , Gs^Fp       , Gs^Fp       , Gs^Fp       , Gs^Fp       , Gs^Fp       , Gs^Fp       , Gs^Fp       , Gg          , Hh          , Hh          , Ww          , Ww          , Ww          , Hh          , Hh          , Ww          , Ww          , Ss          , Gg          , Gg          , Gg          , Re          , Re          , Re          , Re          , Gg          , Gg          , Gg          , Gs^Fp       , Gs^Fp       , Gg          , Gg          , Gs          , Gs          , Gs          , Gg          , Gg          , Gg^Ve       , Gs^Fp       , Gs^Fp       , Hh          , Hh          , Hh          , Hh          , Hh          , Gg          , Gs^Fp       , Gg^Ve       , Gg          , Gg          , Gg          , Gg          , Gg          , Gg          , Re          , Gs          , Gs          , Gg          , Gg          , Gg          , Gg          
Gg          , Gg          , Gs^Fp       , Gs^Fp       , Gg          , Gg          , Gs^Fp       , Gg          , Ce          , Hh          , Hh          , Hh          , Hh          , Hh          , Mm          , Hh          , Ww          , Ww          , Ss          , Gg          , Gg          , Re          , Re          , Gg          , Gg          , Gs^Fp       , Gs^Fp       , Gg          , Gs^Fp       , Gg^Ve       , Gs^Fp       , Gg          , Gg          , Gs          , Gs          , Gs          , Gg          , Gs^Fp       , Gs^Fp       , Gs^Fp       , Gs^Fp       , Gs^Fp       , Hh          , Hh          , Hh          , Gg          , Gg          , Gs^Fp       , Gs^Fp       , Gg          , Ds          , Gg          , Gg          , Gg          , Gg          , Re          , Ce          , Ce          , Ce          , Gg          , Gg          , Gg          
Gg          , Gg          , Gg          , Gs^Fp       , Gg          , Gg          , Gg          , Ce          , 4 Ke        , Ce          , Hh          , Mm          , Mm          , Mm          , Mm          , Hh          , Ww          , Ww          , Gg          , Gg          , Gg          , Gg          , Re          , Gs^Fp       , Gs^Fp       , Gs^Fp       , Gs^Fp       , Gs^Fp       , Gg          , Gs^Fp       , Gg          , Gg          , Gg          , Gs          , Gs          , Gs          , Gg          , Gg          , Gg          , Gs^Fp       , Gs^Fp       , Hh          , Mm          , Mm          , Mm          , Gg          , Gs^Fp       , Gs^Fp       , Gs^Fp       , Gs^Fp       , Ds          , Ds          , Ds          , Ds          , Re          , Re          , Ce          , 5 Ke        , Ce          , Gg          , Gg          , Gg          
Gg          , Gg          , Gg          , Gg          , Gg          , Gg          , Gg          , Ce          , Ce          , Ce          , Hh          , Hh          , Hh          , Mm          , Mm          , Hh          , Ww          , Gg          , Gg          , Gg          , Ss          , Gg          , Re          , Gs^Fp       , Gs^Fp       , Gs^Fp       , Gs^Fp       , Gs^Fp       , Gs^Fp       , Gs^Fp       , Gg          , Gg          , Gg          , Gs          , Gs          , Gs          , Gg          , Gg          , Gg          , Gs^Fp       , Gs^Fp       , Hh          , Mm          , Mm          , Hh          , Hh          , Gs^Fp       , Gs^Fp       , Gs^Fp       , Gs^Fp       , Ww          , Ds          , Ds          , Ds          , Re          , Gs^Fp       , Gs^Fp       , Ce          , Gg          , Gg          , Gg          , Gg          
Re          , Re          , Re          , Gg          , Gg          , Gg          , Gg          , Gg          , Gg          , Gg          , Gg          , Hh          , Hh          , Mm          , Hh          , Hh          , Ww          , Gg          , Gg          , Gs^Fp       , Ss          , Gg          , Re          , Gs^Fp       , Gg^Ve       , Gs^Fp       , Gs^Fp       , Gs^Fp       , Gs^Fp       , Gg          , Gg          , Gg          , Gg          , Gg          , Gs^Fp       , Gg          , Gg          , Gg          , Gg          , Gg          , Gg          , Hh          , Hh          , Hh          , Hh          , Gs^Fp       , Gs^Fp       , Gs^Fp       , Ss          , Gs^Fp       , Ds          , Ds          , Ds          , Ww          , Re          , Gg          , Gg^Ve       , Gg          , Gs^Fp       , Gg          , Gg          , Gg          
Gg          , Gg^Vh       , Gg          , Re          , Re          , Gg          , Gg          , Gg          , Gg          , Gg          , Gg          , Hh          , Hh^Vhh      , Hh          , Ww          , Ww          , Ss          , Gg          , Gg          , Gs^Fp       , Gs^Fp       , Gg          , Gg          , Re          , Re          , Re          , Gs^Fp       , Gs^Fp       , Gs^Fp       , Gg          , Gg          , Gg          , Gg          , Gg          , Gs^Fp       , Gg          , Gg          , Gg          , Gs          , Gg          , Hh          , Hh          , Hh          , Hh          , Hh          , Hh          , Gg          , Gg          , Gs^Fp       , Gs^Fp       , Gs^Fp       , Gg          , Ds          , Ww          , Re          , Gg          , Gg          , Gg          , Gg          , Gg^Ve       , Gs^Fp       , Gs^Fp       
Gg          , Gg          , Gg          , Gg          , Gg          , Gs          , Re          , Gs          , Gs          , Gg          , Gs          , Gg          , Gg          , Ww          , Gg          , Gg          , Gg          , Gg          , Gg          , Gg          , Gs^Fp       , Gs          , Gs          , Gs          , Gs          , Re          , Re          , Gs^Fp       , Gs^Fp       , Gs^Fp       , Gs^Fp       , Gg          , Gg          , Gg          , Gs^Fp       , Gg          , Gg          , Gs          , Gs          , Gs          , Gg          , Gg^Vh       , Gg          , Gg          , Gg          , Gg          , Hh          , Gs^Fp       , Gg^Ve       , Gs^Fp       , Gs^Fp       , Gs^Fp       , Gs^Fp       , Ds          , Re          , Gg          , Gs          , Gg          , Gg          , Gg          , Gs^Fp       , Gs^Fp       
Hh          , Hh          , Hh          , Gg          , Gg          , Gs          , Gs          , Re          , Re          , Gs          , Re          , Re          , Re          , Ww          , Gg          , Gg          , Gg          , Gg          , Gs^Fp       , Gg          , Gg          , Gs          , Gs          , Gs          , Gs          , Gg          , Gg          , Re          , Gg          , Gg          , Gg          , Gs^Fp       , Gs^Fp       , Gs^Fp       , Gs^Fp       , Gg          , Gg          , Gs          , Gs          , Gs          , Gs          , Gg          , Gg          , Gg          , Gg          , Hh          , Hh          , Gg          , Gg          , Gg          , Gg          , Gg          , Gg          , Re          , Gg          , Gs          , Gs          , Gs          , Gg          , Ds          , Ds          , Ds          
Hh          , Hh          , Gs^Fp       , Gg          , Gg          , Gg          , Gg          , Gg          , Gg          , Re          , Hh          , Gs          , Ww          , Ww^Bw\      , Re          , Gg          , Gg          , Gg          , Gs^Fp       , Gs^Fp       , Gg          , Gs          , Gs          , Gs          , Gs          , Gs          , Gg          , Re          , Gg          , Gg          , Gg          , Gs^Fp       , Gs^Fp       , Gs^Fp       , Gs^Fp       , Gg          , Gg          , Gg          , Gs          , Gs          , Gs          , Gs          , Gg          , Gg          , Gg          , Gg          , Gg          , Gg          , Gg          , Gg          , Gg          , Gg          , Gg          , Re          , Gs          , Gs          , Gs          , Gs          , Ds          , Ds          , Ww          , Ww          
Gs^Fp       , Gs^Fp       , Ww          , Gs^Fp       , Gs^Fp       , Gs^Fp       , Gs^Fp       , Gg          , Gg          , Hh          , Ww          , Ww          , Ww          , Ww          , Re          , Gg          , Gs^Fp       , Gs^Fp       , Gs^Fp       , Gs^Fp       , Gg          , Gs          , Gs          , Gs          , Gs          , Gs          , Gg          , Re          , Re          , Gg          , Gg          , Gs^Fp       , Ds          , Ss          , Ss          , Ss          , Gg          , Gg          , Gg^Vh       , Gs          , Gs          , Gs          , Gg          , Gg          , Gg          , Gg          , Gg          , Gg          , Gg          , Gg          , Gg          , Gg          , Gg          , Re          , Gs          , Gs          , Gs          , Gg          , Ds          , Ds          , Ww          , Ww          
Ww          , Ww          , Ww          , Gs^Fp       , Hh          , Hh          , Gs^Fp       , Gg          , Ww          , Ww          , Ww          , Ww          , Ss          , Gg          , Gg          , Gs^Fp       , Gg^Vh       , Gs^Fp       , Gs^Fp       , Gs^Fp       , Gs^Fp       , Gs          , Gs          , Gs          , Gs          , Gs          , Gg          , Gg          , Re          , Gg^Vh       , Gg          , Ds          , Ss          , Ss          , Ss          , Ss          , Ss          , Ds          , Ww          , Ds          , Ds          , Ds          , Ds          , Gg          , Gg          , Gg          , Gg          , Gg          , Gg          , Gg          , Gg^Ve       , Gg          , Gg          , Re          , Gs          , Gs          , Gs          , Gg          , Gg          , Gg          , Ds          , Ds          
Ww          , Ww          , Ww          , Gs^Fp       , Hh          , Hh          , Gs^Fp       , Gg          , Ww          , Ww          , Ss          , Ss          , Gg          , Gg          , Gg          , Re          , Gs^Fp       , Gs^Fp       , Gs^Fp       , Gs^Fp       , Gs^Fp       , Gs          , Gs          , Gs          , Gs          , Gs          , Re          , Re          , Gs          , Re          , Re          , Gg          , Ss          , Ss          , Ww          , Ww          , Ww          , Ww          , Ww          , Ww          , Ds          , Ds          , Gg          , Gg          , Gg          , Gg          , Gg          , Gg          , Gg          , Gg          , Gg          , Gg          , Re          , Gs          , Gs          , Gs          , Gs          , Gg          , Gg          , Gg          , Gg          , Gg          
Wo          , Wo          , Ww          , Gs^Fp       , Gs^Fp       , Gs^Fp       , Ww          , Ww          , Gg          , Gg          , Gg          , Gg          , Gg          , Gg          , Gs          , Re          , Re          , Gs          , Gs          , Gs          , Gs          , Gs          , Gs          , Gs          , Gs          , Re          , Gs          , Gs          , Gs          , Gg          , Re          , Gg          , Gg          , Gs^Fp       , Gs^Fp       , Ds          , Ds          , Ds          , Ds          , Ds          , Gg          , Gg          , Gg^Ve       , Gg          , Gg          , Gg          , Gg          , Gg          , Gg          , Gg^Ve       , Gg          , Gg          , Re          , Gs          , Gs          , Gs          , Gg          , Gg          , Gs          , Gs          , Gs          , Gs          
Wo          , Wo          , Wo          , Ww          , Ww          , Ww          , Gs^Fp       , Gs^Fp       , Gs^Fp       , Gs^Fp       , Gs^Fp       , Gs^Fp       , Gs          , Gs          , Gs          , Gs^Fp       , Gs          , Re          , Re          , Gs          , Gg          , Gs          , Re          , Re          , Gs          , Gs          , Ds          , Gs          , Gg          , Gg          , Re          , Gg          , Gg          , Gg          , Gg^Ve       , Gs^Fp       , Gs^Fp       , Ss          , Gg          , Gg          , Gg          , Gg          , Gg          , Gg          , Gg          , Gg          , Gs          , Gg          , Gg          , Gg          , Re          , Re          , Gg          , Gg          , Gg          , Gg          , Gg          , Gg          , Gs          , Gs          , Gs          , Gs          
Wo          , Wo          , Wo          , Ww          , Dd^Vda      , Gs^Fp       , Gs^Fp       , Gs^Fp       , Gs^Fp       , Gs^Fp       , Gs^Fp       , Gs          , Gg^Vh       , Gs          , Gs          , Gs          , Ce          , Gs          , Gg          , Re          , Re          , Re          , Gg          , Gs          , Gs          , Gs          , Ds          , Ds          , Gg          , Gg          , Gg          , Re          , Gg          , Gg          , Gg          , Gs^Fp       , Ss          , Gs^Fms      , Gg          , Gg          , Gg          , Gg          , Gg          , Gg          , Gg          , Gs          , Gs          , Gs          , Re          , Re          , Gs          , Gg          , Gg          , Gg          , Gg          , Gg          , Gg          , Gg          , Gg          , Gs          , Gg          , Gg          
Wo          , Wo          , Wo          , Ww          , Gs^Fp       , Gs^Fp       , Gs^Fp       , Gs^Fp       , Gs^Fp       , Gs^Fp       , Gs^Fp       , Gs^Fp       , Gs          , Gs          , Gs          , Ce          , 6 Ke        , Ce          , Gg          , Gg          , Re          , Gg^Vh       , Gg          , Gg          , Gg          , Gg          , Ds          , Ds          , Gg          , Gg          , Gg          , Re          , Re          , Gg          , Gg          , Gs^Fms      , Gs^Fms      , Gs^Fms      , Gg          , Gg          , Gg          , Gg          , Gg          , Gg          , Gg          , Gs          , Ce          , Ce          , Ce          , Gs          , Gs          , Gs          , Gg          , Gg          , Gg          , Gg          , Gg          , Gg          , Gg          , Gg          , Gg          , Gg          
Wo          , Wo          , Ww          , Ww          , Gs^Fp       , Gs^Fp       , Gs^Fp       , Gs^Fp       , Gs^Fp       , Gs^Fp       , Gs^Fp       , Gs^Fp       , Gs          , Gs          , Gs          , Ce          , Ce          , Ce          , Gg          , Gg          , Re          , Gg          , Gg          , Gg          , Gg          , Gg          , Ce          , Ce          , Ce          , Gg          , Rr          , Rr          , Ch          , Gg          , Gg          , Gg^Ve       , Gg          , Gg          , Gg          , Gs^Fms      , Gs^Fms      , Gs^Fms      , Gs^Fds      , Gg          , Re          , Re          , Ce          , 7 Ke        , Ce          , Gs          , Gs          , Gs          , Gg          , Gg^Vh       , Gg          , Gg          , Gg          , Gg          , Gg          , Gg          , Gg^Ve       , Gg          
Ww          , Ww          , Ww          , Ww          , Gs^Fp       , Gs^Fp       , Gs^Fp       , Gs^Fp       , Gs^Fp       , Gs^Fp       , Gs^Fp       , Gs          , Gs          , Gs          , Re          , Re          , Re          , Re          , Re          , Re          , Gg          , Gg          , Gg          , Gg          , Gg          , Gg          , Ce          , 1 Ke        , Ce          , Rr          , Gg^Vh       , Ch          , 2 Kh        , Ch          , Gg          , Gg          , Gg          , Gg          , Gg          , Gs          , Gs          , Gs^Fds      , Re          , Re          , Gs^Fms      , Gs^Fms      , Hh          , Ce          , Gs          , Gs          , Gs          , Gs          , Gs          , Gg          , Gg          , Gg          , Gg          , Gg          , Gg          , Gg          , Gs^Fp       , Gs^Fp       
Gs^Fp       , Gs^Fp       , Gs^Fp       , Gs^Fp       , Gs^Fp       , Gs^Fp       , Gs^Fp       , Gs^Fp       , Wo          , Wo          , Gs^Fp       , Gs^Fp       , Re          , Re          , Gg          , Gg          , Gg          , Re          , Gg          , Gg          , Gg          , Gg          , Gg          , Gg          , Gs          , Gg          , Gg          , Ce          , Rr          , Rr          , Rr          , Ch          , Ch          , Ch          , Re          , Re          , Re          , Gg          , Gg^Vh       , Gs          , Gs          , Gs          , Re          , Gs^Fms      , Gs^Fms      , Gs^Fms      , Gg          , Gg          , Gs          , Gs          , Gs          , Gs          , Gs          , Gg          , Gg          , Gg          , Gg          , Gg          , Gg          , Gs^Fp       , Gs^Fp       , Gs^Fp       
Gs^Fp       , Gs^Fp       , Gs^Fp       , Gs^Fp       , Gs^Fp       , Gs^Fp       , Gs^Fp       , Gs^Fp       , Gs^Fp       , Wo          , Re          , Re          , Gg          , Gg          , Gg          , Gg          , Gg          , Re          , Gg          , Gg          , Ds          , Gg          , Gg          , Gs          , Gs          , Gs          , Gg^Vh       , Gg          , Rr          , Gg          , Ds          , Ch          , Ds          , Ch          , Gg          , Gg          , Gg          , Re          , Re          , Gs          , Gs          , Gs          , Re          , Gs^Fms      , Gs^Fms      , Gs^Fms      , Gg          , Gg          , Gg          , Gs          , Gs          , Gs          , Gs          , Gg          , Gg          , Gg          , Gg          , Gg          , Gg          , Gs^Fp       , Gs^Fp       , Gs^Fp       
Gs^Fp       , Gs^Fp       , Gs^Fp       , Gs^Fp       , Gg          , Gs^Fp       , Gg          , Gs^Fp       , Re          , Re          , Ds          , Ds          , Gg          , Gg          , Gg          , Gg          , Gg          , Re          , Re          , Gg          , Ds          , Gs          , Gs          , Gs          , Gs          , Gs          , Gg          , Gg          , Rr          , Gg          , Gg          , Ds          , Ds          , Gg          , Gg          , Gg          , Gg          , Gg          , Re          , Gg          , Gg          , Gg          , Re          , Gg          , Gs          , Gs^Fms      , Gg^Vh       , Gg          , Gg          , Gg          , Gg          , Gs          , Gg          , Gg          , Gg          , Gg          , Gg          , Gs^Fp       , Gs^Fp       , Gs^Fp       , Gs^Fp       , Gs^Fp       
Gs^Fp       , Gs^Fp       , Gs^Fp       , Gg          , Gs^Fp       , Gs^Fp       , Re          , Re          , Ds          , Re          , Wo          , Ds          , Gg          , Gg          , Gg^Vh       , Gg          , Gg          , Gg          , Gg          , Re          , Re          , Gs          , Gs          , Gs          , Gs          , Gs          , Gs          , Rr          , Rr          , Gs          , Gs          , Gg          , Gg          , Gg          , Gg          , Gg          , Gg          , Gg          , Gg          , Re          , Re          , Re          , Gg          , Gs          , Gs          , Gs          , Re          , Re          , Re          , Gg          , Gg          , Gg          , Gg          , Gg          , Gs^Fp       , Gg          , Gg          , Gs^Fp       , Gg^Ve       , Gs^Fp       , Gs^Fp       , Gs^Fp       
Re          , Re          , Gs^Fp       , Gg          , Gs^Fp       , Gg^Ve       , Re          , Gg          , Ds          , Ds          , Wo          , Wo          , Ds          , Gg          , Gg          , Gg          , Gg          , Gg          , Gg          , Gg          , Gg          , Gs          , Gs          , Gs          , Gs          , Gs          , Re          , Rr          , Gs          , Gs          , Gs          , Gs          , Ds          , Gg          , Gg          , Gg          , Gg          , Gg          , Gg          , Gg          , Ds          , Re          , Gg          , Gs          , Gs          , Gs          , Ds          , Ds          , Ds          , Re          , Re          , Gg          , Gg          , Gg          , Gs^Fp       , Gs^Fp       , Gs^Fp       , Gs^Fp       , Gs^Fp       , Gs^Fp       , Gs^Fp       , Gs^Fp       
Re          , Re          , Gs^Fp       , Gg          , Gs^Fp       , Gg          , Re          , Gg          , Ds          , Ds          , Wo          , Wo          , Ds          , Gg          , Gg          , Gg          , Gg          , Gg          , Gg          , Gg          , Gg          , Gs          , Gs          , Gs          , Gs          , Gs          , Re          , Rr          , Gs          , Gs          , Gs          , Gs          , Ds          , Gg          , Gg          , Gg          , Gg          , Gg          , Gg          , Gg          , Ds          , Re          , Gg          , Gs          , Gs          , Gs          , Ds          , Ds          , Ds          , Re          , Re          , Gg          , Gg          , Gg          , Gs^Fp       , Gs^Fp       , Gs^Fp       , Gs^Fp       , Gs^Fp       , Gs^Fp       , Gs^Fp       , Gs^Fp       
