border_size=1
usage=map

Mm          , Mm          , Mm          , Mm          , Mm          , Mm          , Mm          , Mm          , Mm          , Mm          , Mm          , Rb          , Mm          , Mm          , Mm          , Mm          , Mm          , Hh          , Ha          , Ha          , Ha          , Aa          , Aa          , Aa          , Ai          , Sm          , Sm          , Gg          , Gg          , Gg          , Gs^Fp       , Gs^Fp       , Gs^Fp       , Gs          , Gs          , Gs^Fp       , Gs          , Gs          , Hh          , Hh          , Mm          , Mm          
Mm          , Mm          , Mm          , Mm          , Mm          , Mm          , Mm          , Mm          , Mm          , Mm          , Mm          , Rb          , Rb          , Mm          , Mm          , Mm          , Mm          , Mm          , Hh          , Hh          , Hh          , Hh          , Gg^Vh       , Sm          , Gg          , Aa          , Gg          , Gg          , Gs^Fp       , Gs^Fp       , Gs^Fp       , Gs^Fp       , Gs^Fp       , Gs^Fp       , Gs          , Gs          , Gs          , Gs          , Gd^Vo       , Hh          , Mm          , Mm          
Mm          , Mm          , Mm          , Mm          , Mm          , Mm          , Mm          , Mm          , Mm          , Mm          , Hh          , Mm          , Rb          , Mm          , Mm          , Mm          , Mm          , Hh          , Hh          , Hh          , Hh          , Gg          , Ww          , Ww          , Gg          , Gg          , Hh          , Hh          , Hh          , Gg          , Gg          , Gg          , Gs^Fp       , Gs^Fp       , Gg          , Gg          , Gs          , Gs          , Gs          , Gs          , Hh          , Mm          
Mm          , Mm          , Mm          , Mm          , Mm          , Mm          , Hh          , Hh          , Hh          , Hh          , Hh          , Hh          , Mm          , Rb          , Rb          , Ha          , Hh          , Hh          , Hh          , Hh          , Gg          , Gs^Fp       , Sm          , Sm          , Gs^Fp       , Hh          , Ce          , Ce          , Ce          , Hh          , Gs          , Gs          , Hh          , Gs^Fp       , Gs          , Gs          , Gs          , Gs          , Gs          , Gs          , Hh          , Hh          
Rb          , Rb          , Rb          , Rb          , Rb          , Mm          , Hh          , Hh          , Hh          , Hh          , Hh          , Hh          , Mm          , Mm          , Ha          , Rb          , Rb          , Hh          , Gg^Vh       , Gg          , Gs^Fp       , Gs^Fp       , Ww          , Ww          , Gs^Fp       , Hh          , Ce          , 4 Kea       , Ce          , Hh          , Gs          , Gs          , Gs          , Gs          , Gs          , Hh          , Gs          , Gs          , Hh          , Gs          , Hh          , Hh          
Mm          , Mm          , Mm          , Mm^Vhh      , Mm          , Rb          , Rb          , Hh          , Mm          , Hh          , Mm          , Mm          , Mm          , Ha          , Hh          , Hh          , Hh          , Rb          , Rb          , Gg          , Gg          , Gs^Fp       , Ww          , Gs^Fp       , Gs^Fp       , Ce          , Ce          , Ce          , Hh          , Gs          , Hh          , Hh          , Hh          , Gs          , Hh^Vhh      , Hh          , Gs          , Hh          , Hh          , Hh          , Ww          , Hh          
Mm          , Mm          , Mm          , Mm          , Hh          , Hh          , Hh          , Rb          , Rb          , Mm          , Mm          , Mm          , Hh          , Hh          , Gg          , Gs^Fp       , Gs^Fp       , Gs^Fp       , Gs^Fp       , Rb          , Rb          , Gg          , Sm          , Gs^Fp       , Rb          , Rb          , Hh          , Hh          , Hh          , Gs          , Hh          , Hh          , Hh          , Gs          , Gs          , Gs          , Gs          , Hh          , Ce          , Ce          , Ce          , Ww          
Mm          , Mm          , Hh          , Hh          , Hh          , Hh          , Hh          , Mm          , Mm^Vhh      , Rb          , Ce          , Ce          , Ce          , Gg          , Gg          , Gs^Fp       , Gs^Fp       , Gs^Fp       , Gg          , Gg          , Rb          , Gg          , Sm          , Ww          , Rb          , Gg          , Hh          , Hh          , Hh          , Gs          , Gs          , Hh          , Gs          , Gs          , Gs          , Gg          , Gs          , Gs          , Ce          , 5 Kea       , Ce          , Ww          
Mm          , Mm          , Hh          , Hh          , Hh          , Hh          , Mm          , Mm          , Hh          , Hh          , Ce          , 3 Kea       , Ce          , Rb          , Gg          , Gs^Fp       , Gs^Fp       , Gg          , Rb          , Ww          , Ww^Bw|      , Gd^Vo       , Ww          , Sm          , Sm          , Rb          , Rb          , Ha          , Gs          , Gs          , Gs          , Hh          , Hh          , Gs          , Hh          , Hh          , Gs          , Gs          , Gs          , Ce          , Ww          , Ww          
Mm          , Mm          , Hh          , Hh          , Hh          , Mm          , Ai          , Ha          , Ha          , Hh          , Gg          , Ce          , Rb          , Rb          , Rb          , Rb          , Rb          , Rb          , Gg          , Ww^Bw\      , Aa          , Ww          , Ww          , Ww          , Ww          , Ai          , Ai          , Ha          , Ww          , Hh^Vhh      , Hh          , Hh          , Gs          , Gs          , Hh          , Hh          , Gs          , Gs          , Gs          , Gs          , Ww          , Ww          
Mm          , Mm          , Hh          , Hh          , Hh          , Ai          , Ai          , Ai          , Ha          , Aa          , Gg          , Gg          , Rb          , Gg          , Gg          , Gg          , Gg^Vh       , Ww          , Ww          , Ai          , Aa          , Aa          , Rb          , Ww          , Rb          , Aa          , Aa          , Ai          , Ww          , Hh          , Hh          , Hh          , Hh          , Gs          , Gs          , Gs          , Hh          , Gs          , Gs          , Ww          , Ww          , Ww          
Mm          , Mm          , Mm          , Hh          , Ww          , Mm          , Ai          , Ai          , Ha          , Aa          , Aa          , Aa          , Aa          , Aa          , Ww          , Gg          , Gg          , Ww          , Ww          , Ww          , Rb          , Aa          , Aa          , Rb          , Gg          , Rb          , Rb          , Ha          , Sm          , Hh          , Hh          , Hh          , Mm          , Hh          , Gs          , Hh          , Hh          , Hh          , Hh          , Ww          , Ww          , Ww          
Mm          , Mm          , Ww          , Ww          , Ww^Vm       , Ww          , Ww          , Ai          , Ha          , Aa          , Aa          , Gg          , Gg          , Rb          , Ww          , Ww          , Ww          , Ww          , Rb          , Rb          , Gg          , Aa          , Aa          , Gg          , Rb          , Rb          , Ss          , Ha          , Ww          , Hh          , Mm          , Mm          , Mm^Vhh      , Mm          , Hh          , Mm          , Hh          , Hh          , Hh          , Hh          , Ww          , Ww          
Mm          , Mm          , Hh          , Ww          , Gg          , Ww          , Ww          , Ww          , Ww          , Gg          , Gg          , Gs^Fp       , Gs^Fp       , Rb          , Ww          , Gs^Fp       , Rb          , Rb          , Rb          , Gs^Fp       , Rb          , Aa          , Aa          , Rb          , Gd^Vo       , Gg          , Ss          , Ha          , Sm          , Ha          , Mm          , Mm          , Mm          , Mm          , Hh          , Mm          , Mm          , Hh          , Hh          , Hh          , Mm          , Mm          
Mm          , Mm          , Hh          , Gg          , Gg          , Gg          , Ww          , Ww          , Ww          , Ww          , Gs^Fp       , Gs^Fp       , Gg          , Rb          , Ww^Bw\      , Rb          , Rb          , Rb          , Gd^Vo       , Rb          , Rb          , Aa          , Rb          , Rb          , Rb          , Gg          , Ss          , Hh          , Ww          , Ha          , Hh          , Hh          , Hh          , Hh          , Mm          , Mm          , Hh          , Hh          , Hh          , Hh          , Mm          , Mm          
Mm          , Mm          , Mm          , Hh          , Hh          , Gg          , Ww          , Ww          , Ww          , Ww          , Ww          , Gg^Vh       , Ww          , Ww          , Ww^Bw|      , Rb          , Gg^Ve       , Gs^Fp       , Rb          , Rb          , Gs^Fp       , Rb          , Gg          , Gg          , Gg          , Rb          , Ss          , Ss          , Sm          , Ha          , Ha          , Mm          , Hh          , Mm          , Hh          , Hh          , Mm          , Mm          , Mm          , Hh          , Mm          , Mm          
Mm          , Mm          , Mm          , Hh          , Hh          , Hh          , Ww          , Ww          , Hh          , Ww          , Hh          , Ww          , Ww          , Gs^Fp       , Rb          , Gs^Fp       , Rb          , Rb          , Gg          , Gg          , Gg          , Gs^Fp       , Hh          , Hh          , Hh          , Rb          , Ss          , Ss          , Ww          , Hh          , Hh          , Hh          , Hh          , Mm          , Hh          , Mm          , Mm          , Mm          , Mm          , Hh          , Mm          , Hh          
Mm          , Mm          , Mm          , Mm          , Hh          , Hh          , Ww          , Hh          , Hh          , Hh          , Hh          , Gs^Fp       , Rb          , Rb          , Rb          , Rb          , Hh          , Hh          , Hh          , Hh          , Hh          , Hh          , Hh          , Hh          , Hh          , Rb          , Hh          , Ss          , Sm          , Hh          , Hh          , Hh          , Hh          , Hh          , Mm          , Mm          , Mm          , Mm          , Mm          , Hh          , Hh          , Hh          
Mm          , Mm          , Mm          , Mm          , Mm          , Hh          , Ww          , Mm          , Hh          , Hh          , Hh          , Rb          , Hh          , Hh          , Rb          , Hh          , Ha          , Ha          , Ha          , Hh          , Hh          , Hh          , Hh          , Hh          , Hh          , Rb          , Hh          , Gg          , Hh          , Ww          , Mm^Vhh      , Hh          , Hh          , Hh          , Hh          , Mm          , Mm          , Mm          , Mm          , Ha          , Hh          , Hh          
Ww          , Ww          , Ww          , Ww          , Ww          , Ww          , Hh          , Hh          , Hh          , Hh          , Hh          , Rb          , Rb          , Rb          , Hh          , Hh          , Hh          , Hh          , Hh          , Mm          , Mm          , Mm          , Hh          , Hh          , Hh^Vhh      , Rb          , Gs^Fp       , Gg          , Sm          , Ww          , Hh          , Hh          , Hh          , Hh          , Mm          , Hh^Vhh      , Hh          , Mm          , Mm          , Hh          , Hh          , Hh          
Mm          , Mm          , Mm          , Mm          , Mm^Vhh      , Hh          , Hh          , Hh          , Hh          , Hh          , Rb          , Rb          , Gd^Vo       , Hh          , Hh          , Hh          , Mm          , Hh          , Hh          , Mm          , Mm          , Hh          , Hh          , Hh          , Hh          , Rb          , Rb          , Gg          , Ww          , Hh^Vhh      , Hh          , Hh          , Hh          , Mm          , Mm          , Mm          , Mm          , Hh          , Hh          , Hh          , Hh          , Gs^Fp       
Mm          , Mm          , Mm          , Mm          , Hh          , Hh          , Hh          , Hh          , Hh          , Rb          , Hh          , Rb          , Hh          , Hh          , Hh          , Hh          , Mm          , Mm          , Hh          , Hh          , Mm          , Hh          , Hh          , Hh          , Hh          , Gg          , Rb          , Ss          , Ww          , Hh          , Hh          , Hh          , Mm          , Mm          , Mm          , Mm          , Hh          , Hh          , Hh          , Hh          , Gs^Fp       , Hh          
Mm          , Mm          , Mm          , Hh          , Hh          , Hh          , Hh          , Hh          , Hh          , Rb          , Rb          , Rb          , Hh          , Hh          , Hh          , Mm          , Hh          , Hh          , Hh          , Hh          , Hh          , Hh          , Hh^Vhh      , Hh          , Hh          , Hh          , Rb          , Ss^Vhs      , Sm          , Hh          , Hh          , Mm          , Mm          , Mm          , Hh          , Hh          , Hh          , Hh          , Ww          , Hh          , Ww          , Gg          
Hh          , Hh          , Hh          , Hh          , Ha          , Aa          , Gg          , Gg^Vh       , Rb          , Rb          , Gg          , Gg          , Gg          , Hh          , Hh          , Hh          , Hh          , Hh          , Hh          , Hh          , Hh          , Hh          , Hh          , Gs^Fp       , Gs^Fp       , Hh          , Wwf         , Wwf         , Ww          , Hh          , Hh          , Hh          , Hh          , Hh          , Hh          , Hh          , Hh          , Ww          , Gs^Fp       , Ww          , Gg          , Ww          
Hh          , Hh          , Ww          , Gg          , Ww          , Ai          , Gg          , Gg          , Rb          , Aa          , Gg          , Gg          , Gg          , Hh          , Hh          , Hh          , Hh          , Ha          , Ha          , Hh          , Hh          , Hh          , Gs^Fp       , Gs^Fp       , Gg          , Sm          , Ss          , Rb          , Ww          , Ww          , Ww          , Hh          , Hh          , Hh          , Ww          , Ww          , Ww          , Ww          , Gs^Fp       , Gg^Ve       , Gs^Fp       , Gs^Fp       
Hh          , Hh          , Ww          , Ww          , Aa          , Aa          , Gg          , Gg          , Rb          , Gg          , Gg          , Gg          , Hh          , Hh          , Hh          , Hh          , Hh          , Ha          , Ha          , Hh          , Hh          , Gs^Vl       , Gs^Fp       , Gg          , Sm          , Sm          , Gg          , Rb          , Hh          , Ww          , Ww          , Ww          , Ww          , Ww          , Ww          , Gg          , Gg          , Gg          , Gs^Fp       , Gs^Fp       , Gg          , Gs^Fp       
Ww          , Hh          , Ww          , Gg^Vh       , Aa          , Aa          , Gg          , Gg          , Rb          , Gg          , Gg          , Gg          , Gs^Fp       , Hh          , Hh          , Gg^Vh       , Gg          , Ha          , Ha          , Hh          , Hh          , Gg          , Gg          , Sm          , Gg          , Gg          , Gg          , Aa          , Gg          , Aa          , Aa          , Ai          , Ai          , Ww          , Gd^Vo       , Gg          , Gg          , Gg          , Gs^Fp       , Gg          , Gg          , Gs^Fp       
Hh          , Ww          , Gg          , Gg          , Aa          , Gg          , Rb          , Gg          , Gg          , Gg          , Gg          , Gg          , Gs^Fp       , Gg          , Gg          , Gg          , Gg          , Ha          , Ha          , Ha          , Ww          , Hh          , Sm          , Sm          , Gg          , Gg          , Gg          , Rb          , Gg          , Gg          , Aa          , Gs          , Aa          , Aa          , Gg          , Gg          , Gg          , Gs^Fp       , Gs^Fp       , Gg          , Gg          , Gs^Fp       
Hh          , Gg          , Gg          , Gg          , 1 Gg        , Gg          , Rb          , Gs^Fp       , Gs^Fp       , Gg          , Gd^Vo       , Gg          , Gg          , Gg          , Gg          , Gg          , Gs          , Ha          , Ww          , Ww          , Gg          , Ww          , Sm          , Ww          , Gg          , Gg          , Gg          , 2 Rb        , Gg          , Gg          , Gg          , Gs          , Gs          , Aa          , Gg          , Gg          , Gg          , Gg          , Gg          , Gg          , Aa          , Gg          
Hh          , Hh          , Gg          , Gg          , Gs^Fp       , Gs^Fp       , Rb          , Gs^Fp       , Gg          , Gg          , Gg          , Gg          , Gg          , Gg          , Gs          , Gs          , Gs          , Gs          , Ww          , Hh          , Gg          , Gg          , Sm          , Ww          , Gs          , Gg          , Gg          , Aa          , Aa          , Gg          , Rb          , Gs          , Gs          , Gg          , Gg          , Gg          , Gg          , Aa          , Aa          , Aa          , Aa          , Aa          
Hh          , Hh          , Hh          , Gg          , Gs^Fp       , Rb          , Gs^Fp       , Gg          , Gg          , Gg          , Gg          , Aa          , Gs          , Gs          , Hh^Vhh      , Hh          , Hh          , Hh          , Hh          , Ww          , Gd^Vo       , Gg          , Sm          , Gg          , Gs          , Gg^Vh       , Gs          , Gs          , Gs          , Rb          , Gg          , Rb          , Gg          , Gg          , Gg^Vh       , Gg          , Gg          , Aa          , Aa          , Aa          , Aa          , Aa          
Hh          , Hh          , Ww          , Ww          , Ww          , Rb          , Gg          , Gg          , Gg          , Aa          , Ai          , Aa          , Gs          , Gs          , Hh          , Hh          , Hh          , Hh          , Hh          , Ww          , Sm          , Sm          , Gg          , Gg          , Gg          , Gs          , Gg          , Gs          , Gs          , Gs          , Ww          , Gg          , Gs^Fp       , Rb          , Gg          , Gg          , Gg          , Gg          , Gg          , Gg          , Gg          , Aa          
