border_size=1
usage=map

Hh          , Hh          , Hh          , Hh          , Hh          , Hh          , Mm          , Mm          , Mm          , Mm          , Mm          , Mm          , Mm          , Hh          , Mm          , Mm          , Mm          , Hh          , Hh          , Mm          , Xu          , Xu          , Xu          , Xu          , Xu          , Xu          , Xu          , Xu          , Uu          , Uu          , Uu          , Uu          
Hh          , Hh          , Mm          , Mm          , Mm          , Mm          , Mm          , Hh          , Mm          , Mm          , Mm          , Hh^Vhh      , Hh          , Hh          , Hh          , Mm          , Mm^Xm       , Hh          , Mm          , Mm          , Mm          , Xu          , Mm          , Xu          , Mm          , Xu          , Xu          , Uu          , Cud         , Uu          , Uu          , Uu          
Hh          , Hh          , Mm          , Mm          , Mm          , Mm          , Hh          , Mm^Xm       , Mm^Xm       , Mm          , Hh          , Hh          , Hh          , Hh          , Mm          , Mm          , Mm          , Mm^Xm       , Mm^Xm       , Mm          , Mm          , Mm          , Hh          , Mm          , Ha^Vhha     , Hh          , Xu          , Cud         , 2 Kud       , Cud         , Uu          , Uu          
Hh          , Mm          , Mm          , Mm          , Hh          , Hh          , Hh          , Mm          , Mm          , Mm          , Mm          , Mm          , Mm          , Mm          , Mm          , Hh          , Hh          , Mm^Xm       , Mm          , Mm          , Hh          , Hh          , Hh          , Hh          , Hh          , Hh          , Rp          , Cud         , Xu          , Xu          , Xu          , Xu          
Hh          , Hh          , Hh          , Hh          , Ww          , Ww          , Ww          , Ww          , Ww          , Ww          , Ww          , Hh          , Hh          , Mm          , Mm          , Hh          , Hh          , Hh          , Hh          , Hh          , Ha          , Ha          , Ha          , Ha          , Ha          , Hh          , Hh          , Rp          , Rd          , Xu          , Xu          , Xu          
Ww          , Ww          , Ww          , Hh^Vhh      , Ww          , Mm          , Mm          , Mm          , Mm          , Ww          , Ww          , Hh          , Mm          , Mm          , Mm          , Hh          , Hh          , Hh          , Hh^Vhh      , Hh          , Ha          , Ha          , Ha          , Ha          , Ha          , Ha          , Ha          , Ha          , Ha          , Ha          , Hh          , Xu          
Hh          , Ch          , 3 Kh        , Ww          , Hh          , Mm          , Mm          , Mm          , Mm          , Mm          , Ww          , Mm          , Mm          , Mm          , Mm          , Mm^Xm       , Mm          , Hh          , Hh          , Hh          , Hh          , Hh          , Mm          , Mm          , Mm^Xm       , Mm          , Mm          , Mm          , Rp          , Hh          , Ha          , Xu          
Hh          , Ch          , Ch          , Ch          , Hh          , Hh          , Hh          , Mm          , Mm          , Ww          , Ww          , Mm          , Mm          , Mm          , Mm          , Mm          , Mm          , Mm          , Mm          , Hh          , Hh          , Hh          , Mm          , Mm          , Mm          , Mm^Xm       , Mm          , Mm          , Rd          , Hh          , Hh          , Ha          
Hh          , Hh          , Hh          , Hh          , Mm          , Hh          , Hh          , Mm          , Mm          , Ww          , Ww          , Hh          , Ww          , Ww          , Mm          , Mm          , Mm          , Mm          , Mm          , Mm          , Mm          , Mm          , Hh          , Hh          , Mm          , Mm          , Mm          , Hh          , Mm          , Hh          , Hh          , Hh          
Mm          , Mm          , Hh          , Mm          , Mm          , Mm          , Hh          , Mm          , Mm          , Ha          , Ha^Vhha     , Ww          , Hh          , Hh          , Hh          , Hh          , Mm          , Mm          , Mm          , Mm^Xm       , Mm^Xm       , Mm          , Mm          , Hh          , Hh          , Mm          , Mm          , Mm          , Rd          , Mm          , Mm          , Hh          
Mm          , Mm          , Mm          , Mm          , Mm          , Mm          , Hh          , Mm          , Hh          , Ai          , Ai          , Ww          , Mm          , Mm          , Mm          , Hh          , Mm          , Mm          , Mm          , Mm          , Mm          , Mm          , Mm          , Mm          , Hh          , Hh          , Hh          , Hh          , Rp          , Hh          , Hh          , Mm          
Mm          , Mm          , Mm          , Mm          , Mm          , Hh          , Hh          , Mm          , Mm          , Mm^Xm       , Ai          , Ww          , Ww          , Mm          , Mm          , Hh          , Ha          , Ha          , Ha          , Mm          , Mm          , Mm          , Mm          , Mm          , Mm          , Hh          , Rp          , Rd          , Ha^Vhha     , Ha          , Hh          , Hh          
Mm          , Mm          , Mm          , Mm          , Mm          , Mm^Xm       , Mm^Xm       , Mm          , Mm          , Mm          , Mm          , Hh          , Ai          , Ww          , Ww          , Mm          , Ha          , Ha          , Ha          , Ha          , Mm          , Mm          , Mm^Xm       , Mm          , Mm          , Hh          , Rd          , Hh          , Ha          , Ha          , Hh          , Hh          
Mm          , Mm          , Mm          , Mm          , Mm          , Mm          , Mm          , Mm^Xm       , Re          , Mm          , Re          , Aa          , Aa          , Hh          , Hh          , Ai          , Ai          , Ai          , Mm          , Mm          , Mm          , Mm          , Mm          , Mm^Xm       , Mm          , Hh          , Rp          , Hh          , Ha          , Ha          , Hh          , Hh          
Mm          , Mm          , Mm          , Mm          , Mm          , Mm          , Hh          , Re          , Mm          , Re          , Hh          , Ha^Vhha     , Ha          , Re          , Re          , Mm          , Ai          , Mm          , Mm          , Mm          , Mm          , Mm          , Mm          , Mm          , Mm          , Hh          , Hh          , Hh          , Hh          , Mm          , Hh          , Hh          
Mm          , Mm          , Mm          , Mm          , Mm^Vhh      , Mm          , Mm          , Hh          , Mm          , Mm          , Hh          , Hh          , Hh          , Hh          , Hh          , Aa          , Ai          , Aa          , Re          , Mm          , Mm          , Mm          , Mm          , Mm          , Mm          , Hh          , Re          , Hh          , Mm          , Mm          , Hh          , Hh          
Mm          , Mm          , Mm          , Mm          , Mm          , Hh          , Mm          , Mm          , Mm^Xm       , Mm          , Mm          , Mm          , Mm          , Hh          , Ha          , Mm          , Ai          , Mm          , Mm^Vhh      , Re          , Mm          , Mm          , Mm          , Hh          , Hh          , Re          , Mm          , Mm          , Mm          , Mm          , Hh          , Hh          
Mm          , Ha          , Hh          , Mm          , Hh          , Hh          , Mm          , Mm          , Mm          , Mm          , Mm          , Mm          , Mm          , Mm          , Hh          , Mm          , Hh          , Ww          , Ww          , Re          , Hh          , Mm          , Re          , Re          , Hh          , Mm          , Mm          , Mm^Xm       , Mm^Xm       , Mm          , Hh          , Hh          
Ha          , Ha          , Hh          , Hh          , Re          , Mm          , Mm          , Mm          , Mm          , Mm          , Mm          , Mm          , Re          , Hh          , Re          , Re          , Hh          , Re          , Mm          , Ww          , Ww          , Re          , Hh          , Re          , Re          , Hh          , Ww          , Mm          , Mm          , Mm          , Hh          , Hh          
Mm          , Hh          , Hh          , Hh          , Re          , Ha          , Aa          , Hh          , Re          , Re          , Mm          , Re          , Hh          , Hh          , Hh          , Mm          , Mm          , Mm          , Mm          , Mm          , Hh          , Ww          , Ww          , Mm          , Ww          , Ww^Bw\      , Re          , Ww          , Ww          , Ww          , Ww          , Hh          
Mm          , Hh          , Ha          , Hh          , Re          , Aa          , Ha          , Re          , Hh          , Hh          , Mm          , Mm          , Mm          , Mm          , Mm          , Mm          , Mm          , Mm          , Mm^Xm       , Mm^Xm       , Mm          , Hh          , Hh          , Ww          , Ww          , Mm          , Mm          , Re          , Re          , Ww          , Ch          , Hh          
Hh          , Ha          , Ha          , Hh          , Re          , Re          , Mm          , Hh          , Mm          , Mm          , Mm          , Mm          , Mm          , Mm          , Mm^Xm       , Mm          , Mm          , Mm          , Mm          , Mm^Xm       , Mm          , Mm          , Mm          , Mm          , Mm          , Mm          , Mm          , Hh          , Hh^Vhh      , Re          , Ww          , Re          
Hh          , Ha          , Ha          , Aa          , Hh^Vhh      , Hh          , Hh          , Mm          , Mm          , Mm          , Mm          , Mm          , Mm          , Mm          , Mm          , Mm^Xm       , Mm          , Mm          , Mm          , Mm          , Mm          , Mm          , Mm          , Mm          , Mm          , Mm          , Mm          , Hh          , Hh          , Hh          , Gs^Fp       , Ww          
Ha          , Ha          , Ha          , Aa          , Re          , Hh          , Mm          , Mm          , Mm          , Mm          , Mm^Xm       , Mm          , Mm          , Mm          , Mm          , Mm          , Mm          , Mm          , Mm          , Mm          , Mm^Xm       , Mm          , Mm          , Mm          , Mm          , Mm          , Mm          , Hh          , Hh          , Gs^Fp       , Gs^Fp       , Ww          
Hh          , Hh          , Hh          , Hh          , Re          , Hh          , Mm          , Mm          , Mm          , Mm^Xm       , Mm          , Mm          , Mm          , Mm          , Mm          , Mm          , Mm          , Mm          , Mm          , Mm^Xm       , Mm          , Mm          , Mm          , Mm          , Hh          , Hh          , Hh          , Hh          , Hh          , Hh          , Gs^Fp       , Gs^Fp       
Hh          , Hh          , Hh          , Hh          , Re          , Ha          , Ha          , Mm          , Mm          , Mm          , Mm          , Mm          , Mm          , Ha          , Ha          , Ha          , Ha          , Mm          , Mm          , Mm          , Mm          , Mm          , Mm          , Hh          , Hh          , Hh          , Hh          , Hh          , Ch          , Hh          , Gs^Fp       , Gs^Fp       
Hh          , Hh          , Hh          , Hh^Vhh      , Hh          , Aa          , Hh          , Mm          , Mm          , Mm          , Mm          , Mm          , Mm          , Ha          , Ha^Vhha     , Ha          , Hh          , Hh          , Hh          , Mm          , Mm          , Mm          , Ha          , Hh          , Hh          , Hh          , Hh          , Ch          , 4 Kh        , Gg          , Gs^Fp       , Gs^Fp       
Hh          , Hh          , Hh          , Hh          , Hh          , Re          , Hh          , Hh          , Mm          , Mm          , Mm          , Mm          , Mm          , Ha          , Ha          , Ha          , Hh          , Hh          , Hh          , Mm^Vhh      , Hh          , Hh          , Ha          , Ha          , Ha          , Ha          , Ha          , Hh          , Ch          , Ch          , Hh          , Gs^Fp       
Hh          , Hh          , Hh          , Hh          , Ha          , Re          , Ce          , Ce          , Ce          , Mm          , Mm          , Mm          , Mm          , Ha          , Hh          , Hh          , Hh          , Hh          , Mm          , Hh          , Hh          , Hh          , Ha          , Ha          , Ha          , Ha          , Ha          , Ha          , Ha          , Hh          , Hh          , Hh          
Hh          , Hh          , Ha          , Ha          , Ha          , Ha          , Ce          , 1 Ke        , Ce          , Mm          , Mm          , Mm          , Hh          , Hh          , Hh          , Hh          , Mm          , Mm          , Mm          , Hh          , Hh          , Ha          , Ha          , Ha          , Hh          , Ha          , Ha          , Ha          , Ha          , Ha^Vhha     , Hh          , Hh          
Hh          , Hh          , Hh          , Ha          , Ha          , Ha          , Re          , Ce          , Hh          , Mm          , Mm          , Mm          , Mm          , Hh          , Mm          , Mm          , Mm          , Mm          , Hh          , Hh          , Hh          , Hh          , Hh          , Hh          , Hh          , Hh          , Hh          , Hh          , Hh          , Hh          , Hh          , Hh          
Hh          , Hh          , Hh          , Ha          , Ha          , Ha          , Re          , Hh          , Hh          , Mm          , Mm          , Mm          , Mm          , Mm          , Mm          , Mm          , Mm          , Hh          , Hh          , Hh          , Hh          , Hh          , Hh          , Gg          , Gg          , Hh          , Hh          , Hh          , Hh          , Hh          , Hh          , Hh          
