border_size=1
usage=map

Mm          , Mm          , Mm          , Mm          , Mm          , Mm          , Mm          , Mm          , Mm          , Mm          , Mm          , Mm          , Mm          , Mm          , Mm          , Mm          , Mm          , Mm          , Mm          , Mm          , Mm          , Re          , Mm          , Mm          , Mm          , Mm          , Mm          , Mm          , Mm          , Wo          , Mm          , Mm          , Mm          , Mm          , Mm          , Mm          , Hh          , Hh          , Hh          , Hh          , Hh          , Hh          
Mm          , Mm          , Mm          , Mm          , Mm          , Mm          , Mm          , Mm          , Mm          , Mm          , Mm          , Mm          , Mm          , Mm          , Mm          , Mm          , Mm          , Mm          , Mm          , Mm          , Mm          , Re          , Mm          , Mm          , Mm          , Mm          , Mm          , Mm          , Wo          , Wo          , Mm          , Mm          , Mm          , Mm          , Mm          , Mm          , Hh          , Hh          , Hh          , Hh          , Hh          , Hh          
Mm          , Mm          , Mm          , Mm          , Mm          , Mm          , Mm          , Mm          , Mm          , Mm          , Mm          , Mm          , Mm          , Mm          , Mm          , Mm          , Mm          , Mm          , Mm          , Hh          , Re          , Re          , Ha          , Mm          , Ha          , Mm          , Mm          , Mm          , Wo          , Mm          , Mm          , Mm          , Mm          , Mm          , Mm          , Hh          , Hh          , Hh          , Hh          , Hh          , Ha          , Hh          
Mm          , Mm          , Mm          , Mm          , Mm          , Mm          , Mm          , Mm          , Mm          , Mm          , Hh          , Mm          , Mm          , Mm          , Mm          , Mm          , Hh          , Hh          , Hh          , Hh          , Re          , Ha          , Ha          , Ha          , Ha          , Ha          , Ha          , Ww          , Mm          , Mm          , Mm          , Mm          , Mm          , Mm          , Ha          , Hh          , Hh          , Hh          , Hh          , Hh          , Ha          , Ha          
Mm          , Mm          , Mm          , Mm          , Mm          , Mm          , Mm          , Mm          , Mm          , Hh          , Hh          , Hh          , Hh          , Hh          , Ha          , Hh          , Mm          , Mm          , Mm          , Hh          , Re          , Hh          , Mm          , Mm          , Mm          , Ha          , Ai          , Ai          , Ha          , Mm          , Mm          , Ha          , Ha          , Ha          , Hh          , Hh          , Hh          , Hh          , Ha          , Ha          , Ha          , Ha          
Hh          , Hh          , Hh          , Hh          , Hh          , Hh          , Hh          , Hh          , Hh          , Hh          , Aa          , Hh          , Aa          , Aa          , Aa          , Ha          , Mm          , Mm          , Mm          , Re          , Hh          , Hh          , Mm          , Mm          , Mm          , Hh          , Ai          , Hh          , Gg          , Ha          , Ha          , Ha          , Ha          , Ha          , Aa          , Aa          , Gg          , Aa          , Gg          , Ha          , Ha          , Ha          
Hh          , Hh          , Hh          , Hh          , Hh          , Hh          , Hh          , Hh          , Aa          , Aa^Fpa      , Aa^Fpa      , Aa          , Aa^Fpa      , Aa          , Aa          , Aa          , Aa          , Ha          , Ha          , Re          , Hh          , Mm          , Mm          , Mm          , Mm          , Mm          , Ww          , Hh          , Gg          , Gg          , Re          , Ha          , Ha          , Aa          , Gg          , Gg          , Gg          , Gg          , Gg          , Gg          , Gg          , Gg          
Mm          , Mm          , Mm          , Mm          , Mm          , Mm          , Ha          , Aa^Fpa      , Aa^Fpa      , Aa^Fpa      , Aa^Fpa      , Gs^Fp       , Gs^Fp       , Gg          , Gg          , Aa          , Aa^Fpa      , Ha          , Aa          , Re          , Aa          , Hh          , Hh          , Mm          , Hh          , Ww          , Gg          , Hh          , Hh          , Hh          , Gg          , Re          , Re          , Gg          , Gg          , Gg          , Gg          , Gg          , Gg          , Gg          , Gg          , Gg          
Mm          , Mm          , Mm          , Mm          , Mm          , Mm          , Ha          , Aa^Fpa      , Gs^Fp       , Aa^Vha      , Gs^Fp       , Gs^Fp       , Gs^Fp       , Gg          , Gg          , Gg          , Aa          , Aa          , Gg          , Re          , Ai          , Ai          , Wwf         , Hh          , Wwf         , Ww          , Gg          , Hh^Vhh      , Hh          , Hh          , Hh          , Gg          , Gg          , Re          , Re          , Gg          , Hh          , Hh          , Hh          , Hh          , Hh          , Hh          
Mm          , Mm          , Mm          , Mm          , Mm          , Mm          , Ha          , Aa          , Gs^Fp       , Gs^Fp       , Gs^Fp       , Gg          , Re          , Gg          , Gg          , Gg^Vh       , Hh          , Gg          , Ch          , Ai          , Re          , Aa          , Ch          , Ww          , Gg          , Gg          , Hh          , Hh          , Mm          , Mm          , Mm          , Hh          , Hh          , Gg^Vh       , Re          , Hh          , Hh          , Hh          , Hh          , Hh          , Hh          , Hh          
Ha          , Ha          , Ha          , Ha          , Ha          , Ha          , Re          , Gg          , Gg          , Gg          , Re          , Re          , Gg          , Re          , Gg          , Hh          , Hh          , Gg          , Ai          , Ai          , Re          , Aa          , Gg          , Gg          , Gg          , Hh          , Hh          , Mm          , Mm          , Mm          , Mm          , Hh          , Hh          , Gg          , Gg          , Re          , Re          , Gg          , Gg          , Gg          , Gg          , Gg          
Re          , Re          , Re          , Re          , Re          , Re          , Re          , Re          , Re          , Re          , Gg          , Gg          , Gg          , Re          , Ch          , Hh          , Gg          , Hh^Vhh      , Ww          , Gg^Vh       , Re          , Gg^Vh       , Gg          , Gg          , Gg          , Ch          , Hh          , Mm          , Mm          , Mm          , Mm          , Mm          , Hh          , Gg          , Gg          , Gg          , Gg          , Re          , Re          , Re          , Re          , Gg          
Re          , Re          , Re          , Re          , Re          , Re          , Gg          , Gg          , Gg          , Gg          , Gg          , Gg          , Gs^Fp       , Gs^Fp       , Gg          , Re          , Re          , Hh          , Ww          , Gg          , Ce          , Ce          , Ce          , Hh^Vhh      , Hh          , Gg          , Hh          , Mm          , Mm          , Mm          , Hh          , Hh          , Hh          , Gg          , Gs^Fp       , Gs^Fp       , Gg          , Gg          , Gg          , Gg          , Gg          , Re          
Gg          , Gg          , Gg          , Gg          , Gg          , Gg          , Gg          , Gg          , Gg          , Gg          , Gg          , Gs^Fp       , Gs^Fp       , Gg          , Gg          , Gg          , Re          , Hh^Vhh      , Ww          , Gg^Ve       , Ce          , 2 Ke        , Ce          , Ce          , Gs^Fp       , Gg          , Ch          , Hh          , Hh          , Hh          , Hh          , Hh          , Gg          , Gg          , Gs^Fp       , Gs^Fp       , Gs^Fp       , Gs^Fp       , Gs^Fp       , Gs^Fp       , Gs^Fp       , Gg          
Gs^Fp       , Gs^Fp       , Gs^Fp       , Gs^Fp       , Gs^Fp       , Gs^Fp       , Gs^Fp       , Gg          , Gg          , Gg          , Hh          , Hh          , Hh          , Mm          , Ch          , Gg^Ve       , Gg          , Wwf         , Re          , Gg          , Re          , Ce          , Gg^Ve       , Gg          , Gs^Fp       , Gg^Ve       , Gg          , Hh          , Hh          , Gg          , Gg          , Gg          , Gg          , Gg          , Gs^Fp       , Gg^Ve       , Gs^Fp       , Gs^Fp       , Gs^Fp       , Gs^Fp       , Gg          , Gg          
Gg          , Gg          , Gg          , Gg          , Gg          , Gg          , Gs^Fp       , Gs^Fp       , Gg          , Hh          , Hh          , Hh          , Mm          , Mm          , Mm          , Gg          , Gg^Ve       , Ww          , Hh^Vhh      , Re          , Hh          , Gs^Fp       , Gs^Fp       , Gg          , Ch          , Gs^Fp       , Gg          , Gg          , Gg          , Gg          , Gg          , Gg          , Gg          , Gg          , Gs^Fp       , Gs^Fp       , Gs^Fp       , Gs^Fp       , Gs^Fp       , Gs^Fds      , Gs^Fds      , Gg          
Gg          , Gg          , Gg          , Gg          , Gg          , Gg          , Gs^Fp       , Gg          , Gs^Fp       , Hh          , Hh          , Mm          , Hh          , Mm          , Gg          , Ww          , Ww          , Ww          , Hh          , Re          , Re          , Gs^Fp       , Gg^Ve       , Gg          , Gg          , Gs^Fp       , Gs^Fp       , Gg          , Gg          , Gs^Fp       , Gg          , Gg          , Gg          , Gg          , Gg          , Gs^Fp       , Gg^Ve       , Gg          , Gg          , Gs^Fds      , Gs^Fds      , Gs^Fds      
Gs^Fp       , Gs^Fp       , Gs^Fp       , Gs^Fp       , Gs^Fp       , Gs^Fp       , Gs^Fp       , Gg          , Gg^Vh       , Hh          , Hh          , Hh          , Gg          , Hh          , Gg          , Ww          , Gg          , Ch          , Gg          , Gg          , Re          , Ch          , Gs^Fp       , Gs^Fp       , Gs^Fp       , Gg          , Gs^Fp       , Gg          , Gg          , Gg          , Gs^Fp       , Gs^Fp       , Gs^Fp       , Gg          , Gg          , Gs^Fp       , Gs^Fp       , Gs^Fp       , Gs^Fp       , Gg          , Gg          , Gs^Fp       
Gs^Fp       , Gs^Fp       , Gs^Fp       , Gs^Fp       , Gs^Fp       , Gs^Fp       , Gg          , Gg          , Gg          , Gg          , Re          , Re          , Re          , Gg          , Re          , Ww          , Re          , Gg          , Re          , Re          , Gg          , Re          , Gg          , Gs^Fp       , Gs^Fp       , Gs^Fp       , Gg          , Gg          , Gg          , Gg          , Gg          , Gs^Fp       , Gs^Fp       , Gs^Fp       , Gs^Fp       , Gs^Fp       , Gs^Fp       , Gs^Fp       , Gs^Fp       , Gs^Fp       , Gs^Fp       , Gg          
Gg          , Gg          , Gg          , Gg          , Gg          , Gg          , Gg          , Gg          , Re          , Re          , Gg          , Gg          , Gg          , Re          , Gg          , Wwf         , Ww          , Re          , Gg          , Gg          , Gg          , Re          , Re          , Gg          , Gg          , Gg          , Gg          , Gg          , Gg^Vh       , Gg          , Re          , Gs^Fp       , Gs^Fp       , Gs^Fp       , Gs^Fp       , Gs^Fp       , Gg          , Gg          , Gg          , Gg          , Gg          , Gg          
Gg          , Gg          , Gg          , Gg          , Gg          , Gg          , Re          , Re          , Gg          , Gg          , Hh          , Hh          , Gg          , Gg          , Gg          , Ww          , Ww          , Gg^Vh       , Gg          , Gg          , Gg          , Gg          , Gg          , Re          , Re          , Gg          , Gg          , Gg          , Re          , Re          , Gs^Fp       , Re          , Re          , Aa^Fma      , Aa^Fma      , Gs^Fp       , Gs^Fp       , Gs^Fp       , Gs^Fp       , Aa^Fma      , Aa^Fma      , Aa^Fma      
Re          , Re          , Re          , Re          , Re          , Re          , Gg          , Gg          , Gg          , Gg          , Gg          , Ha          , Ha          , Gg          , Hh          , Hh          , Hh          , Ww          , Gg          , Gg          , Gg          , Gg          , Rb          , Re          , Gg          , Re          , Re          , Re          , Gs^Fp       , Gs^Fp       , Gs^Fp       , Gs^Fp       , Gg          , Re          , Gg          , Aa          , Gs^Fp       , Gs^Fp       , Gs^Fp       , Aa^Fma      , Gs^Fp       , Gs^Fds      
Gg          , Gg          , Gg          , Gg          , Gg          , Gg          , Gg^Vh       , Gg          , Gg          , Gg          , Gg          , Hh          , Ha          , Hh          , Hh          , Hh          , Hh          , Ww          , Gg          , Gg          , Gg          , Rb          , Gg          , Gg          , Gg          , Gg          , Gg          , Gg          , Gs^Fp       , Gs^Fp       , Gs^Fp       , Gs^Fp       , Gs^Fp       , Re          , Gs^Fp       , Gs^Fp       , Hh          , Hh          , Hh          , Hh          , Hh          , Hh          
Gg          , Gg          , Gg          , Gg          , Gg          , Gg          , Gg          , Gg          , Gg          , Gg          , Gg          , Gg          , Gg          , Gg          , Gs^Fp       , Hh          , Ww          , Ww          , Gg          , Gg          , Gg          , Rb          , Gg          , Aa          , Aa          , Gg          , Gg          , Hh          , Hh          , Gg^Ve       , Gg          , Gg          , Re          , Re          , Gs^Fp       , Hh          , Hh          , Hh          , Hh          , Hh          , Hh          , Hh          
Gg          , Gg          , Gg          , Gg          , Gg          , Gg          , Gg          , Gs^Fp       , Gg          , Gg          , Gg          , Gg          , Gg          , Gg          , Ww          , Ww          , Hh          , Gg          , Gg          , Gg          , Gg^Vh       , Rb          , Hh          , Ha          , Ha          , Hh          , Hh          , Hh          , Hh          , Gs^Fp       , Gg          , Gg          , Re          , Gg^Ve       , Rb          , Gg          , Gs^Fp       , Gg          , Gg          , Gg          , Gg          , Gg          
Hh          , Ha          , Hh          , Gg          , Hh          , Gg          , Gg          , Gs^Fp       , Ww          , Gg          , Ww          , Gg          , Gg          , Ww          , Gg          , Ww          , Hh          , Gg          , Gg          , Gg          , Gg          , Rb          , Gg          , Ha          , Gg          , Hh          , Hh          , Hh          , Hh          , Gs^Fp       , Gg          , Re          , Ce          , Ce          , Ce          , Gs^Fp       , Hh          , Hh          , Hh          , Gg          , Gg          , Gg          
Gg          , Ha          , Gg          , Hh          , Hh          , Hh          , Ww          , Ww          , Gg          , Ww          , Gg          , Ww          , Ai          , Ai          , Gg          , Gg          , Hh          , Gs^Fp       , Gg^Ve       , Gs^Fp       , Gg          , Gs^Fp       , Gg          , Gg          , Gg          , Gg          , Gg          , Hh          , Hh          , Hh          , Re          , Re          , Ce          , 1 Ke        , Ce          , Gs^Fp       , Gg          , Hh          , Gg          , Gg          , Gg          , Gg          
Gg          , Gg          , Gg          , Gs^Fp       , Ww          , Ww          , Gg          , Gg          , Gg          , Gg          , Gg          , Gg          , Ha          , Aa          , Hh          , Gg          , Hh          , Hh          , Gs^Fp       , Gg          , Gg          , Re          , Gg          , Gg          , Gg          , Gg          , Gg          , Hh          , Gg          , Hh          , Re          , Gg          , Gg          , Ce          , Gg          , Gg          , Gg          , Gg          , Gg          , Gg          , Gg          , Gg          
Gg          , Gg          , Gg          , Ww          , Ww          , Hh          , Gg          , Gg          , Gg          , Gg^Vh       , Gg          , Hh          , Ha          , Ha          , Hh          , Hh          , Hh          , Hh          , Gs^Fp       , Gg          , Gg          , Re          , Gg          , Gg          , Gg          , Gg          , Gg          , Gg          , Gg          , Re          , Gg          , Gg          , Gg          , Gg          , Gg          , Gg          , Gg          , Gg          , Gg          , Gg          , Gg          , Gg          
Gg          , Gg          , Gg          , Ww          , Gg          , Hh          , Gg          , Gg          , Gg          , Gg          , Gg          , Hh          , Gg          , Ha          , Gg          , Hh          , Gg          , Hh          , Gg          , Gg          , Gg          , Re          , Gg          , Gg          , Gg          , Gg          , Gg          , Gg          , Re          , Re          , Gg          , Gg          , Gg          , Gg          , Gg          , Gg          , Rb          , Gg          , Gg          , Gg          , Gg          , Gg          
