border_size=1
usage=map

Xu          , Xu          , Xu          , Xu          , Xu          , Xu          , Xu          , Xu          , Xu          , Xu          , Xu          , Xu          , Xu          , Xu          , Xu          , Xu          , Xu          , Xu          , Xu          , Xu          , Xu          , Xu          , Xu          , Xu          , Xu          , Xu          , Xu          , Xu          , Xu          , Xu          , Xu          , Xu          , Xu          , Qxu         , Qxu         , Xu          , Xu          , Xu          , Xu          , Xu          , Xu          , Xu          , Xu          , Xu          , Xu          , Xu          , Xu          , Xu          , Xu          , Xu          , Xu          , Xu          
Xu          , Xu          , Xu          , Xu          , Xu          , Xu          , Xu          , Xu          , Xu          , Xu          , Xu          , Xu          , Xu          , Xu          , Xu          , Xu          , Xu          , Xu          , Xu          , Xu          , Xu          , Xu          , Xu          , Xu          , Xu          , Xu          , Xu          , Xu          , Xu          , Xu          , Xu          , Xu          , Xu          , Qxu         , Qxu         , Xu          , Xu          , Xu          , Xu          , Xu          , Xu          , Xu          , Xu          , Xu          , Xu          , Xu          , Xu          , Xu          , Xu          , Xu          , Xu          , Xu          
Xu          , Xu          , Xu          , Xu          , Xu          , Xu          , Uu          , Xu          , Xu          , Xu          , Xu          , Xu          , Xu          , Xu          , Xu          , Xu          , Uu          , Xu          , Xu          , Xu          , Uu          , Xu          , Uu          , Xu          , Uu          , Xu          , Xu          , Xu          , Xu          , Xu          , Xu          , Uu          , Uu          , Rd          , Uu          , Qxu         , Xu          , Uu          , Uu          , Uu          , Uu          , Uu          , Uu          , Xu          , Xu          , Xu          , Xu          , Xu          , Xu          , Xu          , Xu          , Xu          
Xu          , Xu          , Xu          , Xu          , Uu          , Uu          , Uu          , Xu          , Xu          , Xu          , Xu          , Xu          , Xu          , Uu          , Uu          , Uu          , Uu          , Xu          , Uu          , Uu          , Uu          , Sm          , Sm          , Sm          , Uu          , Uu          , Uu          , Uu          , Uu          , Xu          , Xu          , Uu          , Uu          , Uu          , Uu          , Qxu         , Uu          , Uu^Ii       , Uu          , Uu^Ii       , Uu^Vu       , Uu          , Uu^Ii       , Xu          , Xu          , Xu          , Xu          , Xu          , Xu          , Xu          , Xu          , Xu          
Xu          , Xu          , Xu          , Uu          , Uu          , Uu          , Uu          , Uu          , Uu          , Xu          , Uu          , Uu          , Uu          , Ww          , Uu          , Uu          , Uu          , Uu          , Rd          , Rd          , Uu          , Uu          , Uu          , Uu          , Uu          , Uu          , Uu          , Uu          , Uu          , Uu          , Uu          , Uu          , Uu          , Uu          , Uu          , Qxu         , Rd          , Uu          , Uu          , Uu          , Uu^Ii       , Uu          , Uu          , Xu          , Xu          , Xu          , Xu          , Xu          , Xu          , Xu          , Xu          , Xu          
Xu          , Xu          , Xu          , Uu          , Uu          , Uu          , Uu          , Uu^Uf       , Uu          , Uu          , Rd          , Rd          , Uu          , Ww          , Ww          , Uu^Vu       , Uu          , Uu          , Uu          , Uu          , Xu          , Xu          , Xu          , Uu          , Uu          , Uu          , Uh          , Uh          , Uu          , Uu          , Rd          , Rd          , Rd          , Uu          , Uu          , Qxu^Bw/r    , Qxu         , Xu          , Xu          , Xu          , Uu          , Uu^Ii       , Xu          , Xu          , Xu          , Xu          , Xu          , Xu          , Xu          , Xu          , Xu          , Xu          
Xu          , Xu          , Uu          , Uu          , Uu          , Uu          , Rd          , Uu          , Uu          , Uu          , Uu          , Uu          , Uu          , Uu^Vud      , Ww          , Uu          , Uu          , Uu          , Uu          , Uu          , Xu          , Xu          , Xu          , Uu^Uf       , Uu          , Uu          , Uh          , Uu          , Uu          , Uu          , Uu          , Uu          , Uu          , Uu          , Uu          , Rd          , Uu          , Qxu         , Xu          , Xu          , Xu          , Xu          , Xu          , Xu          , Uu          , Xu          , Xu          , Xu          , Xu          , Xu          , Xu          , Xu          
Xu          , Xu          , Uu          , Uu          , Uu          , Rd          , Uu          , Uu          , Uu          , Uu          , Uh          , Uu          , Xu          , Uu          , Xu          , Rd          , Uu          , Uu          , Uu^Uf       , Xu          , Xu          , Uu          , Uu          , Uu          , Uu          , Uu          , Uu          , Uu          , Uu          , Uu          , Uu          , Uu          , Uu          , Uu          , Uu          , Uu          , Uu          , Uu          , Uu^Vu       , Uu          , Uu          , Xu          , Uu          , Uu          , Uu          , Xu          , Xu          , Xu          , Xu          , Xu          , Xu          , Xu          
Xu          , Xu          , Xu          , Uu          , Uu          , Uu          , Uu          , Uu          , Uu          , Uu          , Uh          , Xu          , Xu          , Xu          , Ww          , Rd          , Uu          , Uu          , Uu          , Uu          , Xu          , Uu          , Uu          , Uu^Vu       , Uu          , Uu          , Uu          , Uu          , Xu          , Xu          , Uu          , Uu          , Uu          , Uu          , Uu          , Uu          , Uu          , Uu          , Rd          , Uu          , Uu          , Uu          , Ww          , Ww          , Ww          , Ww          , Uu          , Xu          , Xu          , Xu          , Xu          , Xu          
Xu          , Xu          , Xu          , Uu^Vu       , Uu          , Uu          , Uu          , Uu          , Uu          , Uu          , Uu^Vud      , Uu          , Uu          , Ww          , Ww          , Uu          , Uu          , Uu          , Uu          , Uu          , Uu          , Uu          , Uu          , Uu          , Uu          , Uu          , Uu          , Uh          , Xu          , Xu          , Uu          , Uu          , Rd          , Uu          , Uu          , Uu          , Uu          , Uu          , Rd          , Uu          , Uu          , Uu^Vud      , Ww          , Uu          , Uu          , Uh          , Uu          , Uu          , Uu          , Xu          , Xu          , Xu          
Xu          , Xu          , Xu          , Uu          , Uu          , Sm          , Uu          , Sm          , Uu          , Uu          , Uu          , Uh          , Uu          , Ww          , Xu          , Uh          , Uh          , Qxu         , Qxu         , Uu          , Uu          , Uu          , Rd          , Uu          , Xu          , Uu          , Uu          , Uh          , Xu          , Xu          , Uu          , Rd          , Uu          , Xu          , Uu          , Uu          , Uu          , Uu          , Uu          , Uu^Uf       , Uu          , Uu          , Ww          , Uu          , Uu          , Uu          , Uu          , Uu          , Uu          , Uu          , Xu          , Xu          
Xu          , Xu          , Uu          , Uu          , Qxu         , Qxu         , Qxu         , Sm          , Uu          , Uu          , Rd          , Rd          , Xu          , Xu          , Qxu         , Uu          , Qxu         , Qxu         , Uu          , Qxu         , Uu          , Uu          , Uu          , Uu          , Xu          , Xu          , Uu          , Uu          , Uu          , Uu          , Uu          , Uu          , Uu          , Xu          , Xu          , Uh          , Uu          , Uu          , Xu          , Uu          , Uu          , Uu          , Rd          , Rd          , Rd          , Uu          , Uu          , Uu          , Xu          , Xu          , Xu          , Xu          
Qxu         , Qxu         , Qxu         , Qxu         , Uu^Uf       , Uu          , Uu          , Qxu^Bw/r    , Xu          , Xu          , Uu          , Uu          , Rd          , Uu          , Uu          , Qxu         , Uu          , Uu          , Rd          , Qxu         , Rd          , Uu          , Uu          , Uu          , Uu          , Uu          , Rd          , Rd          , Rd          , Uu          , Uu          , Uu^Vu       , Uu          , Xu          , Xu          , Uu          , Uu          , Uu          , Xu          , Xu          , Uu          , Uu          , Uu          , Uh          , Uh          , Uu          , Uu^Uf       , Uu          , Uu^Vud      , Xu          , Xu          , Xu          
Uu          , Uu          , Uu          , Uu          , Uu          , Uu          , Uu          , Qxu         , Qxu         , Qxu         , Qxu         , Uu          , Uu          , Uh          , Qxu         , Qxu         , Uu          , Uu          , Uu          , Qxu         , Qxu         , Uu          , Uu          , Uu          , Uu          , Uu          , Uu          , Uu          , Uu          , Uu          , Uu          , Uu          , Rd          , Rd          , Uu          , Uu          , Uu          , Xu          , Xu          , Xu          , Uu          , Uu          , Uu          , Xu          , Xu          , Xu          , Xu          , Uh          , Uu          , Xu          , Xu          , Xu          
Uu          , Uu          , Uu          , Uu          , Uu          , Uu          , Uu^Uf       , Uu          , Rd          , Rd          , Uu          , Qxu         , Qxu         , Qxu         , Uu          , Uu          , Uu          , Rd          , Uu          , Uu          , Uu          , Qxu         , Qxu         , Qxu         , Qxu         , Uu          , Uu          , Uu          , Uu          , Uu^Uf       , Uu          , Uu          , Uu          , Qxu         , Uu          , Uu          , Uu          , Uu          , Uh          , Uh          , Uu          , Uu          , Uu          , Xu          , Xu          , Xu          , Xu          , Uh          , Uh          , Rd          , Xu          , Xu          
Uu          , Uu          , Uu          , Uu^Vud      , Uu          , Uu          , Uu          , Uu          , Uu          , Uu          , Uu          , Uu          , Ww          , Uu          , Rd          , Rd          , Uu          , Uu          , Uu          , Uu          , Uu          , Uu          , Qxu         , Uu          , Uu          , Qxu         , Qxu         , Rd          , Uu          , Uu          , Qxu         , Qxu         , Qxu         , Qxu         , Qxu         , Uu          , Uu          , Uu          , Uu          , Uh          , Uu          , Uu          , Uu          , Xu          , Xu          , Xu          , Xu          , Xu          , Uh          , Rd          , Xu          , Xu          
Uu          , Uu          , Uu          , Uu          , Cud         , Uu          , Uu          , Uu          , Uu          , Uu          , Uu          , Ww          , Uu          , Uu          , Uu          , Xu          , Xu          , Uu          , Uu          , Uu          , Uu^Uf       , Rd          , Uu          , Uu          , Uu          , Uu          , Qxu         , Qxu         , Qxu         , Qxu         , Uu          , Uu          , Uu          , Rd          , Uu          , Qxu         , Qxu         , Uu          , Qxu         , Qxu         , Qxu         , Uu          , Uu          , Uh          , Uh          , Xu          , Uu          , Uu          , Uh          , Uh          , Uu          , Uu          
Uu          , Uu          , Cud         , Cud         , 2 Kud       , Cud         , Cud         , Uu          , Uu          , Rd          , Uu          , Ww          , Uu          , Uu^Vu       , Uu          , Xu          , Xu          , Uu          , Uu          , Uu^Uf       , Uu          , Uu          , Uu          , Xu          , Uu          , Uu          , Uu          , Uh          , Uh          , Qxu         , Uu          , Rd          , Uu          , Uu          , Xu          , Uu          , Uu          , Qxu         , Uu          , Uu          , Uu          , Qxu         , Qxu         , Uu          , Uu          , Uu          , Cud         , Cud         , Cud         , Uh          , Uu          , Uu          
Uu          , Uu          , Uu          , Cud         , Cud         , Cud         , Uu          , Uu          , Uu          , Uu          , Uu          , Ww          , Ww          , Uu          , Ww          , Uu          , Uu          , Xu          , Xu          , Uh          , Uu          , Uu          , Uu          , Xu          , Uu          , Rd          , Uu          , Xu          , Xu          , Uu          , Uu          , Uu          , Xu          , Xu          , Xu          , Xu          , Uu          , Uu          , Rd          , Uu          , Uu^Vu       , Uu          , Qxu         , Uu          , Uu          , Cud         , Cud         , 3 Kud       , Cud         , Cud         , Uu          , Uu          
Uu          , Uu          , Uu          , Uu          , Uu          , Uu          , Rd          , Uu          , Uu          , Xu          , Xu          , Uu          , Uu          , Ww          , Uu          , Rd          , Uu          , Ww          , Ww          , Uu          , Uu          , Uu          , Xu          , Uu          , Uu          , Rd          , Uu          , Xu          , Xu          , Uu          , Uu          , Uu          , Xu          , Xu          , Uu          , Uu          , Uu          , Uu          , Uu^Uf       , Rd          , Uu          , Uu          , Qxu         , Uu          , Qxu         , Rd          , Uu          , Cud         , Uu          , Uu          , Uu          , Uu          
Xu          , Xu          , Xu          , Uu          , Uu          , Uu          , Rd          , Uu          , Xu          , Xu          , Xu          , Uu          , Uu          , Xu          , Uu          , Rd          , Xu          , Uu          , Uh          , Uh          , Uh          , Uh          , Uh          , Xu          , Uu          , Uu          , Uu          , Uu^Uf       , Uu          , Uu          , Uu          , Uu          , Uu          , Uu          , Uu          , Uu          , Xu          , Xu          , Xu          , Uu^Uf       , Uu          , Uu          , Rd          , Qxu         , Uu          , Qxu         , Qxu^Bw/r    , Uu          , Qxu         , Uu          , Qxu         , Uu          
Xu          , Xu          , Xu          , Xu          , Xu          , Uu          , Uu          , Rd          , Uu          , Uh          , Uu          , Rd          , Rd          , Xu          , Ww          , Ww          , Xu          , Xu          , Xu          , Uu          , Uu          , Uu^Vud      , Uu          , Xu          , Sm          , Uu          , Uu          , Uu          , Uu^Vu       , Uu          , Uu          , Rd          , Uu          , Uu          , Uu          , Xu          , Uu          , Uu          , Xu          , Xu          , Uu          , Uu          , Uu          , Rd          , Uu          , Uu          , Uu          , Qxu         , Uu          , Qxu         , Uu          , Qxu         
Xu          , Xu          , Xu          , Xu          , Uu          , Uu          , Uu          , Uu          , Rd          , Uu          , Uu          , Uu^Uf       , Rd          , Uu          , Uu          , Uu          , Xu          , Xu          , Uu          , Uu          , Rd          , Uu          , Uu          , Ww          , Uu          , Uu          , Uu          , Uu          , Uu          , Xu          , Xu          , Rd          , Uu          , Uu          , Uu          , Rd          , Uu          , Uu          , Rd          , Uu          , Uh          , Uu          , Rd          , Uu          , Uu          , Uu          , Uu          , Uu          , Uu          , Uu          , Uu          , Uu          
Xu          , Xu          , Xu          , Xu          , Uu          , Uu^Vu       , Uu          , Uu          , Xu          , Uu          , Uu          , Uu^Uf       , Uu          , Uu          , Rd          , Uu          , Uu          , Xu          , Ww          , Rd          , Uu          , Uu          , Ww          , Ww          , Uu          , Uu          , Rd          , Uu          , Xu          , Xu          , Xu          , Uu          , Uu          , Uu          , Uu          , Uu          , Xu          , Xu          , Uu          , Uu          , Uu          , Uu          , Uu          , Uu          , Uu          , Uu^Vu       , Uu          , Uu          , Uu          , Uu          , Uu          , Uu          
Xu          , Xu          , Xu          , Xu          , Uu          , Uu          , Uu          , Uu          , Xu          , Xu          , Xu          , Uu          , Uu          , Uu          , Uu          , Rd          , Uu          , Rd          , Ww          , Uu          , Uu          , Uu          , Xu          , Uu          , Uu^Vud      , Uu          , Sm          , Uu          , Uu          , Xu          , Xu          , Uu          , Uu          , Uu          , Uh          , Xu          , Xu          , Xu          , Uu          , Uu          , Uu          , Uu          , Xu          , Uu          , Rd          , Uu          , Uu          , Uu          , Uu          , Uu          , Xu          , Xu          
Xu          , Xu          , Xu          , Xu          , Xu          , Xu          , Xu          , Xu          , Xu          , Xu          , Xu          , Xu          , Xu          , Xu          , Xu          , Uu^Vud      , Uu          , Rd          , Uu          , Ww          , Uu          , Xu          , Xu          , Xu          , Rd          , Ww          , Xu          , Uu          , Uu          , Xu          , Xu          , Uu          , Uu          , Uu          , Uu          , Xu          , Xu          , Xu          , Rd          , Uu          , Uu          , Xu          , Xu          , Uu          , Xu          , Rd          , Uu          , Uu          , Uu          , Uu^Vud      , Xu          , Xu          
Xu          , Xu          , Xu          , Xu          , Xu          , Xu          , Xu          , Xu          , Xu          , Xu          , Xu          , Xu          , Xu          , Xu          , Rd          , Xu          , Xu          , Xu          , Xu          , Xu          , Xu          , Xu          , Rd          , Rd          , Uu          , Uu          , Xu          , Uu          , Uu          , Rd          , Uu          , Uu          , Uu^Uf       , Uu          , Uu          , Xu          , Xu          , Xu          , Rd          , Uu          , Uh          , Xu          , Xu          , Xu          , Xu          , Xu          , Xu          , Uu          , Xu          , Xu          , Xu          , Xu          
Xu          , Xu          , Xu          , Xu          , Xu          , Xu          , Xu          , Xu          , Xu          , Xu          , Uu          , Uu          , Rd          , Xu          , Uu          , Uu          , Uu          , Uu          , Uu          , Uu          , Rd          , Uu          , Uu          , Uu          , Cud         , Cud         , Xu          , Uu          , Uu          , Uu          , Uu          , Uu          , Rd          , Uu          , Uu          , Uh          , Uh          , Uh          , Uu          , Uu          , Xu          , Xu          , Xu          , Xu          , Xu          , Xu          , Xu          , Xu          , Xu          , Xu          , Xu          , Xu          
Xu          , Xu          , Xu          , Xu          , Xu          , Xu          , Xu          , Xu          , Xu          , Xu          , Ww          , Uu^Vud      , Uu          , Rd          , Uu          , Uu          , Rd          , Rd          , Ww          , Uu^Vu       , Uu          , Rd          , Uu          , Cud         , Cud         , Kud         , Xu          , Uu          , Xu          , Xu          , Xu          , Uu^Vud      , Xu          , Uu          , Uu          , Uu          , Uu          , Uu          , Uu          , Uu          , Xu          , Xu          , Xu          , Xu          , Xu          , Xu          , Xu          , Xu          , Xu          , Xu          , Xu          , Xu          
Xu          , Xu          , Xu          , Xu          , Xu          , Xu          , Xu          , Xu          , Xu          , Xu          , Xu          , Ww          , Uu          , Uu          , Uu          , Uu          , Uu          , Ww          , Ww          , Ww          , Ww          , Uu          , Uu          , Cud         , Xu          , Xu          , Xu          , Xu          , Xu          , Xu          , Xu          , Xu          , Xu          , Uu          , Uu          , Uu          , Uu^Vud      , Uu          , Uu^Vu       , Uu          , Xu          , Xu          , Xu          , Xu          , Xu          , Xu          , Xu          , Xu          , Xu          , Xu          , Xu          , Xu          
Xu          , Xu          , Xu          , Xu          , Xu          , Xu          , Xu          , Xu          , Xu          , Xu          , Xu          , Xu          , Uu          , Cud         , 1 Kud       , Cud         , Uu          , Xu          , Xu          , Xu          , Xu          , Xu          , Xu          , Xu          , Xu          , Xu          , Xu          , Xu          , Xu          , Xu          , Xu          , Xu          , Xu          , Xu          , Xu          , Xu          , Xu          , Xu          , Xu          , Xu          , Xu          , Xu          , Xu          , Xu          , Xu          , Xu          , Xu          , Xu          , Xu          , Xu          , 4 Kh        , Ch          
Xu          , Xu          , Xu          , Xu          , Xu          , Xu          , Xu          , Xu          , Xu          , Xu          , Xu          , Xu          , Uu          , Uu          , Uu          , Uu          , Xu          , Xu          , Xu          , Xu          , Xu          , Xu          , Xu          , Xu          , Xu          , Xu          , Xu          , Xu          , Xu          , Xu          , Xu          , Xu          , Xu          , Xu          , Xu          , Xu          , Xu          , Xu          , Xu          , Xu          , Xu          , Xu          , Xu          , Xu          , Xu          , Xu          , Xu          , Xu          , Xu          , Xu          , Ch          , Ch          
