border_size=1
usage=map

       Gg,       Gg,       Gg,       Mm,       Gg,       Hh,       Hh,       Gg,       Gg,       Gg,       Hh,       Hh,       Gg,       Gg,       Gg,       Ww,       Hh,       Gg,       Re,       Gg,       Gg,       Gg,       Gg,       Gg,    Gs^Fp,       Gg,       Gg,       Gg
       Gg,       Gg,       Gg,       Mm,       Gg,       Hh,       Hh,       Gg,       Gg,       Gg,       Hh,       Hh,       Gg,       Gg,       Gg,       Ww,       Hh,       Gg,       Re,       Gg,       Gg,       Gg,       Gg,       Gg,    Gs^Fp,       Gg,       Gg,       Gg
       Gg,       Gg,       Gg,       Gg,       Gg,       Hh,       Hh,       Gg,       Gg,       Gg,       Hh,       Hh,       Gg,       Gg,       Gg,       Ww,       Ww,       Hh,       Gg,       Gg,       Gg,       Gg,       Gg,    Gs^Fp,    Gs^Fp,       Gg,       Gg,       Gg
       Gg,       Gg,       Gg,       Gg,       Gg,       Hh,       Hh,       Hh,       Hh,       Hh,       Hh,       Hh,       Gg,       Gg,       Ww,       Ww,       Hh,       Hh,       Ww,       Gg,       Gg,       Gg,    Gs^Fp,       Gg,       Gg,       Gg,       Gg,       Gg
       Gg,       Gg,       Gg,       Gg,       Gg,       Gg,       Gg,       Gg,       Gg,       Ce,     4 Ke,       Ce,       Gg,       Ww,       Ww,       Gg,       Ww,       Ww,      Wwf,       Re,       Re,       Gg,       Gg,       Gg,    Gs^Fp,       Gg,       Gg,       Gg
       Hh,       Hh,       Ww,       Ww,       Gg,       Gg,       Re,       Re,       Gg,       Ce,       Gg,       Ce,       Gg,       Gg,       Re,       Ww,       Gg,       Re,       Ww,       Ww,       Re,       Gg,       Gg,       Gg,       Gg,    Gs^Fp,       Gg,       Gg
       Hh,       Hh,       Ww,       Ww,   Ww^Bw/,       Re,       Ww,       Gg,       Ww,       Gg,       Gg,       Gg,       Gg,       Re,       Ww,       Gg,       Ww,       Ww,       Gg,       Aa,       Gg,       Re,       Re,       Re,       Re,       Gg,       Re,       Re
   Hh,   Hh^Vhh,       Ww,       Wo,       Wo,       Ww,       Ww,       Ww,       Hh,       Ww,       Ww,       Ww,       Ww,       Ww,       Gg,       Ww,       Ww,       Hh,       Hh,       Gg,       Gg,       Re,       Gg,    Gg^Vh,       Aa,       Re,       Gg,       Gg
       Ww,       Ww,       Wo,       Wo,       Ww,       Ww,       Ww,       Ww,   Hh^Vhh,       Hh,       Ww,       Ww,       Ww,       Ww,       Gg,       Gg,       Gg,       Hh,       Hh,       Hh,       Re,       Re,       Gg,       Gg,       Gg,       Gg,       Gg,       Gg
       Wo,       Wo,       Ww,   Ww^Bw\,       Gg,       Gg,       Gg,       Ww,       Gg,       Gg,       Gg,       Ww,       Gg,       Gg,       Gg,       Gg,       Gg,       Hh,       Hh,       Hh,       Re,       Gg,       Ce,       Gg,     5 Ke,       Gg,       Gg,       Gg
       Ww,       Ww,       Ww,       Gg,       Gg,       Gg,       Gg,       Gg,       Hh,       Gg,       Gg,       Gg,       Gg,       Hh,       Ha,       Hh,       Hh,       Hh,       Hh,       Gg,       Re,       Ce,     3 Ke,       Ce,       Gg,       Gg,       Gg,       Gg
       Gg,       Gg,       Gg,       Gg,       Gg,       Gg,       Hh,       Hh,       Hh,       Hh,       Hh,       Hh,       Hh,       Hh,       Ha,       Ha,       Hh,       Mm,       Hh,       Hh,       Re,       Ce,       Ce,       Ce,       Gg,       Gg,       Gg,       Gg
       Gg,       Gg,       Gg,       Gg,       Gg,       Gg,    Gs^Fp,       Hh,       Ha,       Ha,       Ha,       Hh,   Mm^Vhh,       Hh,       Mm,       Mm,       Hh,       Hh,       Hh,       Re,       Gg,    Gs^Fp,    Gg^Ve,    Gs^Fp,    Gs^Fp,       Gg,       Gg,       Gg
       Gg,       Gg,       Gg,    Gg^Vh,       Gg,       Gg,       Gg,       Hh,       Mm,       Ha,       Mm,       Hh,       Hh,       Mm,   Mm^Vhh,       Mm,       Mm,       Mm,       Ha,       Re,       Gg,    Gs^Fp,    Gs^Fp,    Gs^Fp,    Gs^Fp,       Gg,       Gg,       Gg
       Gg,       Gg,       Gg,       Gg,       Gg,       Gg,   Hh^Vhh,       Gg,       Mm,       Mm,       Mm,   Mm^Vhh,       Mm,       Mm,       Mm,       Mm,   Mm^Vhh,       Ha,       Ha,       Re,       Re,       Gg,    Gs^Fp,    Gs^Fp,    Gs^Fp,       Gg,       Gg,       Gg
       Gg,       Gg,       Hh,       Gg,       Gg,       Gg,       Gg,       Gg,       Hh,       Mm,   Mm^Vhh,       Mm,      Cud,      Cud,   Mm^Vhh,       Mm,       Mm,       Ha,   Mm^Vhh,       Mm,       Re,       Gg,       Gg,    Gs^Fp,    Gs^Fp,    Gs^Fp,       Gg,       Gg
       Gg,       Gg,       Hh,       Hh,       Gg,       Gg,       Hh,       Hh,       Hh,       Hh,       Hh,       Mm,      Cud,       Kud,       Mm,      Cud,      Cud,       Mm,       Mm,       Mm,       Mm,       Re,       Re,       Gg,    Gs^Fp,       Gg,       Re,       Re
       Gg,       Gg,       Hh,       Hh,       Gg,       Hh,       Mm,       Mm,       Mm,       Hh,       Mm,       Mm,       Mm,   Mm^Vhh,      Cud,     2 Kud,      Cud,       Mm,   Mm^Vhh,       Mm,       Hh,       Hh,       Re,       Gg,       Re,       Re,       Gg,       Gg
       Gg,       Gg,       Gg,       Hh,       Gg,       Hh,       Hh,       Mm,       Hh,       Hh,       Mm,   Mm^Vhh,       Mm,       Mm,       Mm,      Cud,   Mm^Vhh,       Mm,       Hh,       Hh,       Mm,       Hh,       Hh,       Re,    Gs^Fp,       Gg,       Gg,       Gg
       Hh,       Hh,       Hh,       Gg,       Gg,       Hh,       Hh,       Hh,       Mm,       Mm,       Hh,       Mm,       Mm,   Mm^Vhh,       Hh,       Mm,       Mm,       Mm,       Mm,       Hh,       Mm,       Mm,       Hh,       Re,    Gg^Vh,    Gs^Fp,       Gg,       Gg
       Hh,       Hh,       Gg,       Gg,       Ds,       Hh,       Hh,       Mm,       Mm,       Hh,       Mm,       Hh,       Hh,       Mm,       Hh,       Mm,       Mm,       Mm,       Mm,       Hh,       Hh,       Mm,       Hh,       Re,       Gg,    Gs^Fp,       Gg,       Gg
       Gg,       Gg,       Gg,       Ds,       Ss,       Hh,       Hh,       Hh,       Hh,       Hh,       Hh,       Mm,       Mm,       Hh,       Mm,       Mm,    Gs^Fp,       Mm,       Hh,       Hh,       Mm,       Mm,       Re,       Re,       Gg,       Gg,       Gg,       Gg
       Gg,       Gg,       Ss,       Ss,       Ss,       Ss,       Hh,       Hh,       Hh,       Hh,       Hh,       Mm,       Hh,       Hh,    Gg^Vh,       Gg,    Gs^Fp,   Hh^Vhh,       Hh,       Hh,       Gg,       Re,       Gg,       Gg,    Gs^Fp,       Gg,       Gg,       Gg
       Gg,       Gg,       Ds,       Ss,    Gg^Vh,       Ss,       Ss,       Gg,       Hh,       Hh,       Hh,       Hh,       Hh,       Gg,       Gg,       Gg,    Gs^Fp,    Gs^Fp,    Gs^Fp,       Gg,       Gg,       Re,       Gg,       Gg,    Gs^Fp,    Gs^Fp,       Gg,       Gg
       Gg,       Gg,       Ds,       Ss,       Gg,       Gg,       Gg,       Gg,       Gg,       Gg,       Gg,       Hh,    Gs^Fp,    Gs^Fp,    Gs^Fp,       Gg,       Gg,    Gs^Fp,       Gg,       Gg,       Re,       Re,       Re,       Gg,       Gg,       Gg,       Gg,       Gg
       Gg,       Gg,    Gs^Fp,       Ss,    Gs^Fp,       Gg,       Gg,       Gg,       Gg,       Gg,       Gg,       Gg,       Gg,    Gs^Fp,    Gg^Ve,    Gs^Fp,       Re,       Gg,       Re,       Re,    Gs^Fp,    Gs^Fp,       Gg,       Re,       Gg,       Gg,       Gg,       Gg
       Gg,       Gg,    Gs^Fp,       Ss,       Ss,    Gs^Fp,       Gg,       Gg,       Gg,       Re,       Re,       Re,       Re,    Gs^Fp,    Gs^Fp,       Re,       Gg,       Re,       Gg,       Re,       Gg,       Gg,       Gg,       Re,    Gg^Vh,       Gg,       Gg,       Gg
       Gg,       Gg,    Gg^Vh,       Ds,       Ss,       Ss,       Ce,       Ce,       Ce,       Gg,       Gg,       Gg,       Gg,       Re,       Re,       Re,       Gg,       Gg,    Gs^Fp,       Gg,       Gg,       Gg,       Gg,       Re,       Gg,       Gg,       Gg,       Gg
       Gg,       Gg,       Gg,       Gg,       Gg,       Gg,       Ce,     1 Ke,       Ce,       Gg,       Gg,       Gg,       Gg,       Gg,       Gg,       Gg,       Gg,       Gg,    Gs^Fp,    Gs^Fp,       Gg,       Gg,       Re,       Re,       Gg,       Gg,       Gg,       Gg
       Re,       Re,       Re,       Re,       Gg,       Re,       Gg,       Ce,       Gg,       Gg,       Gg,       Gg,       Gg,       Gg,       Gg,       Gg,       Gg,       Gg,    Gs^Fp,    Gg^Ve,    Gs^Fp,       Re,    Gs^Fp,    Gs^Fp,       Gg,       Gg,       Gg,       Gg
       Gg,       Gg,       Gg,       Gg,       Gg,       Gg,       Gg,       Gg,       Gg,    Gg^Vh,       Gg,       Gg,       Gg,       Gg,       Gg,       Gg,       Gg,       Gg,       Gg,    Gs^Fp,       Gg,       Re,       Re,       Gg,       Gg,       Gg,       Gg,       Gg
       Gg,       Gg,       Gg,       Gg,       Gg,       Gg,       Gg,       Gg,       Gg,    Gg,       Gg,       Gg,       Gg,       Gg,       Gg,       Gg,       Gg,       Gg,       Gg,    Gs^Fp,       Gg,       Re,       Re,       Gg,       Gg,       Gg,       Gg,       Gg
