border_size=1
usage=map

Mm          , Mm          , Mm          , Mm          , Mm          , Mm          , Mm          , Mm          , Mm          , Ww          , Ww          , Mm          , Mm          , Mm          , Mm          , Mm          , Mm          , Mm          , Mm          , Gs^Fp       , Hh          , Hh          , Mm          , Mm          , Mm          , Mm          , Mm          , Mm          , Mm          , Mm          , Mm          , Mm          , Mm          , Mm          , Mm          , Mm          , Mm          , Mm          , Re          , Mm          , Mm          , Hh          , Mm          , Mm          , Mm          , Mm          , Mm          , Mm          , Mm          , Mm          
Mm          , Mm          , Mm          , Mm          , Mm          , Mm          , Mm          , Mm          , Mm          , Ww          , Ww          , Mm          , Mm          , Mm          , Mm          , Mm          , Mm          , Mm          , Mm          , Gs^Fp       , Hh          , Hh          , Mm          , Mm          , Mm          , Mm          , Mm          , Mm          , Mm          , Mm          , Mm          , Mm          , Mm          , Mm          , Mm          , Mm          , Mm          , Mm          , Re          , Mm          , Mm          , Hh          , Mm          , Mm          , Mm          , Mm          , Mm          , Mm          , Mm          , Mm          
Mm          , Mm          , Mm          , Mm          , Mm          , Mm          , Mm          , Mm          , Mm          , Mm          , Mm          , Ww          , Mm          , Mm          , Mm          , Hh          , Mm          , Mm          , Mm          , Hh          , Hh          , Hh          , Mm          , Mm          , Mm          , Mm          , Mm          , Mm          , Mm          , Mm          , Mm          , Mm          , Mm          , Mm          , Mm          , Mm          , Hh          , Hh          , Hh          , Re          , Gg          , Mm          , Mm          , Mm          , Mm          , Mm          , Mm          , Mm          , Mm          , Mm          
Mm          , Mm          , Mm          , Mm          , Mm          , Mm          , Mm          , Mm          , Mm          , Mm          , Mm          , Ww          , Ww          , Mm          , Mm          , Hh          , Hh          , Hh          , Hh          , Mm          , Mm          , Mm          , Mm          , Mm          , Mm          , Mm          , Mm          , Mm          , Mm          , Mm          , Mm          , Mm          , Mm          , Mm          , Mm          , Mm          , Mm          , Hh          , Hh          , Re          , Gg          , Gs^Fp       , Mm          , Mm          , Mm          , Mm          , Mm          , Mm          , Mm          , Mm          
Mm          , Mm          , Mm          , Mm          , Mm          , Mm          , Hh          , Hh          , Hh          , Mm          , Mm          , Mm          , Ww          , Mm          , Hh          , Hh          , Gg          , Gg          , Gg          , Gg          , Gg          , Hh          , Hh          , Mm          , Mm          , Mm          , Mm          , Mm          , Mm          , Mm          , Mm          , Mm          , Ce          , Mm          , Mm          , Mm          , Mm          , Hh          , Hh          , Gs^Fp       , Gs^Fp       , Mm          , Hh^Vhh      , Mm          , Mm          , Mm          , Mm          , Mm          , Mm          , Mm          
Mm          , Mm          , Mm          , Mm          , Hh          , Hh          , Gg          , Hh          , Hh          , Mm          , Mm          , Mm          , Gg          , Ww          , Ww          , Gg          , Ww          , Gg^Vh       , Gg          , Gs^Fp       , Gg          , Gg          , Hh          , Gg          , Mm          , Gg^Ve       , Mm          , Mm          , Mm          , Gg^Ve       , Mm          , Ce          , 6 Ke        , Ce          , Mm          , Mm          , Mm          , Mm          , Mm          , Gs^Fp       , Re          , Gg          , Hh          , Hh          , Mm          , Mm          , Mm          , Mm          , Mm          , Mm          
Mm          , Mm          , Mm          , Mm          , Hh          , Hh          , Gg          , Hh          , Hh          , Mm          , Hh          , Mm          , Mm          , Ww          , Gg          , Ai          , Ww          , Aa          , Aa^Fpa      , Aa^Fpa      , Aa          , Gg          , Hh          , Gg          , Mm          , Mm          , Mm          , Mm          , Mm          , Mm          , Hh          , Ce          , Ce          , Ce          , Mm          , Mm          , Hh          , Mm          , Hh          , Re          , Mm          , Mm          , Mm          , Mm          , Mm          , Mm          , Mm          , Mm^Vhh      , Mm          , Mm          
Mm          , Mm          , Mm          , Mm          , Hh          , Hh          , Gg          , Gg          , Hh          , Mm          , Hh          , Mm          , Mm          , Ww          , Ww          , Ww          , Ai          , Ai          , Ai          , Gs^Fp       , Gs^Fp       , Gg          , Gg          , Hh          , Mm          , Mm          , Mm          , Mm          , Gg          , Hh          , Gg          , Hh          , Mm          , Mm          , Hh          , Hh          , Hh          , Hh          , Gg^Ve       , Gs^Fp       , Mm          , Hh          , Mm          , Mm          , Mm          , Mm          , Mm          , Mm          , Mm          , Mm          
Mm          , Mm          , Mm          , Mm          , Hh          , Gg          , Gg          , Gg          , Hh          , Mm          , Mm          , Mm          , Mm          , Ww          , Ww          , Ww          , Ai          , Ai          , Ai          , Gs^Fp       , Gs^Fp       , Gg          , Gg          , Hh          , Mm          , Mm          , Hh          , Hh          , Gg          , Hh          , Hh          , Hh          , Mm          , Hh          , Hh          , Hh          , Re          , Re          , Gs^Fp       , Gs^Fp       , Mm          , Hh          , Hh          , Hh          , Mm          , Mm          , Mm          , Mm          , Mm          , Mm          
Mm          , Mm          , Mm          , Hh          , Gg          , Gg          , Gg          , Gg          , Aa          , Hh          , Hh          , Hh          , Hh          , Hh          , Ww          , Gg          , Ai          , Ai          , Aa          , Gg          , Gg          , Gg          , Gg          , Hh          , Hh          , Mm          , Hh          , Hh          , Hh          , Hh          , Hh^Vhh      , Hh          , Hh          , Hh          , Re          , Re          , Re          , Re          , Gg          , Gs^Fp       , Mm          , Hh          , Hh          , Hh          , Mm          , Mm          , Mm          , Mm          , Mm          , Mm          
Mm          , Mm          , Mm          , Hh          , Hh          , Gg          , Gg          , Gg          , Aa^Fpa      , Aa          , Aa          , Gg          , Gg          , Hh          , Ww          , Ww          , Aa          , Ai          , Aa          , Gg          , Gg          , Gg          , Hh          , Hh          , Hh          , Hh          , Hh          , Hh          , Hh          , Hh          , Hh          , Hh          , Hh          , Re          , Gg          , Gg          , Gg          , Gg          , Gg          , Gs^Fp       , Gs^Fp       , Mm          , Mm          , Mm          , Mm          , Mm          , Mm          , Gg^Vh       , Mm          , Mm          
Mm          , Mm          , Mm          , Mm          , Hh          , Gg          , Gg          , Gg          , Gg          , Aa          , Gg^Vh       , Aa          , Gg          , Ww          , Ww          , Ww          , Aa          , Ai          , Aa          , Gg          , Gg          , Gg          , Gg          , Hh          , Hh          , Hh          , Hh          , Hh          , Hh          , Gg          , Gg          , Gg          , Re          , Re          , Gg          , Gg          , Aa          , Aa          , Hh          , Hh          , Hh          , Mm          , Mm          , Mm          , Hh          , Mm          , Mm          , Mm          , Mm          , Mm          
Mm          , Mm          , Mm          , Mm          , Hh          , Hh          , Hh          , Gg          , Gg          , Gg          , Gg          , Re          , Re          , Ww          , Ww          , Ww          , Ww          , Ww          , Gg^Vh       , Gg          , Gg          , Gg          , Gs^Fp       , Gg          , Gg          , Gg          , Gg          , Gg          , Re          , Re          , Re          , Re          , Gg          , Gg          , Gg          , Aa          , Aa          , Hh          , Hh          , Hh          , Hh          , Hh          , Hh          , Ha          , Hh          , Ha          , Mm          , Mm          , Mm          , Mm          
Mm          , Mm          , Mm          , Mm          , Hh          , Ha          , Hh          , Hh          , Gg          , Gg          , Gg          , Gg          , Re          , Ww          , Ww          , Ww          , Ww          , Gg          , Gs^Fp       , Gg          , Gg          , Gg          , Gs^Fp       , Gs^Fp       , Gs^Fp       , Gg          , Gg          , Gg          , Re          , Re          , Gg          , Hh          , Hh          , Gg          , Gg          , Gg          , Gg          , Hh          , Hh^Vhh      , Hh          , Hh          , Hh          , Hh          , Hh          , Ha          , Mm          , Mm          , Mm          , Gg          , Gg          
Mm          , Mm          , Mm          , Mm          , Hh          , Hh          , Hh          , Hh          , Gg          , Gs^Fp       , Gs^Fp       , Gs^Fp       , Re          , Gs^Fp       , Ww          , Ww          , Ww          , Gg          , Gg          , Gg          , Gg          , Gg          , Gg          , Gg          , Re          , Gg          , Re          , Re          , Gg          , Gg          , Aa          , Ha          , Ha          , Aa^Fpa      , Aa^Fpa      , Gg          , Gg          , Hh          , Hh          , Hh          , Hh          , Hh          , Hh          , Hh          , Gg          , Gg          , Aa          , Gg          , Gg          , Gg          
Mm          , Mm          , Mm          , Mm          , Mm          , Hh          , Hh          , Hh          , Gs^Fp       , Gg          , Gg          , Gg          , Re          , Gg          , Gs^Fp       , Ww          , Ww          , Gg          , Gg          , Gg          , Ch          , Gg          , Re          , Ch          , Gg^Vh       , Ch          , Re          , Gg          , Aa          , Aa          , Ha          , Ha          , Hh          , Gs^Fp       , Gs^Fp       , Gg          , Gg          , Hh          , Hh          , Mm          , Hh          , Hh          , Hh          , Gg          , Gg          , Aa          , Gg          , Gg          , Gg          , Gg          
Mm          , Mm          , Mm          , Mm          , Mm          , Mm          , Hh          , Hh          , Gg          , Gg          , Gg          , Gg          , Re          , Re          , Re          , Ww          , Re          , Re          , Re          , Re          , Re          , Re          , Gg          , Re          , Re          , Re          , Gg          , Gg          , Ch          , Aa          , Aa          , Ha          , Hh          , Gs^Fp       , Gs^Fp       , Gg          , Gg          , Gg          , Hh          , Mm          , Hh          , Hh          , Hh          , Gs^Fp       , Ww          , Gg          , Gg          , 5 Ke        , Gg          , Gg          
Mm          , Mm          , Mm          , Mm          , Mm          , Hh          , Hh          , Hh          , Gg          , Gg          , Gg          , Re          , Gg          , Gs^Fp       , Gg          , Ch          , Gg          , Gg^Ve       , Gg          , Gg          , Gg^Vh       , Gg          , Gg          , Gg^Vh       , Ch          , Gg          , Gg^Ve       , Gg          , Gg          , Aa          , Aa          , Hh          , Hh          , Gs^Fp       , Gg          , Gg          , Gg          , Gg          , Hh          , Hh          , Ww          , Ww          , Ww          , Ww          , Gs^Fp       , Ww          , Ww          , Gg          , Gg          , Gg          
Mm          , Mm          , Hh          , Hh          , Hh          , Hh          , Hh          , Hh          , Gg          , Gg          , Re          , Re          , Gg          , Gs^Fp       , Gg          , Ww          , Gg          , Aa          , Gg          , Gg          , Gg          , Gg          , Gg          , Ch          , 2 Kh        , Ch          , Gg          , Gg^Vh       , Gg          , Gg          , Aa          , Ha          , Hh          , Gg          , Gg          , Gg          , Gg          , Gg          , Gg          , Gg          , Ww          , Hh          , Hh          , Gg          , Gs^Fp       , Hh          , Hh          , Ww          , Ww          , Ww          
Hh          , Hh          , Gg          , Gg          , Gg          , Hh          , Hh          , Gs^Fp       , Re          , Re          , Gg          , Gg          , Gs^Fp       , Gs^Fp       , Gg          , Ai          , Gg          , Gg          , Gg^Ve       , Gg          , Gg          , Gg^Ve       , Gg          , Ch          , Ch          , Ch          , Gg          , Gg          , Gg          , Gg          , Hh          , Ch          , Hh          , Gg          , Gg          , Gg          , Gg          , Gg          , Ww          , Ww          , Hh          , Hh          , Hh          , Gg          , Gs^Fp       , Hh          , Mm          , Mm          , Hh          , Hh          
Gg          , Gg          , Rb          , 4 Ke        , Rb          , Re          , Re          , Re          , Gs^Fp       , Gs^Fp       , Gs^Fp       , Gg          , Gs^Fp       , Gg          , Ww          , Ai          , Gg          , Aa          , Gg          , Gg^Vh       , Aa          , Hh^Vhh      , Hh          , Gg          , Re          , Gg          , Aa          , Gg^Ve       , Gg          , Gg^Vh       , Gg          , Hh^Vhh      , Hh          , Hh          , Hh          , Gg          , Ww          , Ww          , Gg          , Gg          , Hh          , Hh          , Hh          , Gs^Fp       , Gs^Fp       , Mm          , Mm          , Mm          , Hh          , Hh          
Re          , Re          , Gg          , Rb          , Gg          , Gg          , Gg          , Gg^Vh       , Gg          , Gg          , Gg          , Gg          , Gg          , Ww          , Gg^Vh       , Ch          , Aa          , Gg          , Gg          , Gg          , Gg          , Gg          , Gg          , Re          , Gg          , Re          , Gg          , Gg          , Gg          , Gg          , Gg          , Hh          , Hh          , Hh          , Mm^Vhh      , Gg          , Ww          , Gg          , Gg          , Gg          , Hh          , Hh          , Hh^Vhh      , Hh          , Gs^Fp       , Mm          , Mm          , Mm          , Hh          , Hh          
Gg          , Gg          , Hh          , Gg          , Gg          , Gg          , Gg          , Gg          , Aa          , Aa          , Aa          , Aa          , Gg          , Ww          , Gg          , Gg          , Aa          , Gg^Ve       , Gg          , Gg          , Gg^Vh       , Gg          , Re          , Re          , Gg^Vh       , Re          , Gg          , Gg          , Gg^Vh       , Aa          , Gg          , Ch          , Hh          , Gg          , Gg          , Gg          , Gg          , Ww          , Gg          , Gg          , Gg          , Hh          , Hh          , Hh          , Hh          , Mm          , Mm          , Mm          , Mm          , Mm          
Hh          , Hh          , Hh          , Hh          , Gg          , Gg          , Gg          , Gg          , Gg          , Aa          , Aa          , Aa          , Aa          , Ww          , Gg          , Gg          , Gg          , Gg          , Aa          , Gg          , Re          , Re          , Gg          , Gg          , Gg          , Re          , Re          , Gg^Ve       , Gg          , Gg          , Aa          , Gg          , Hh          , Hh          , Gg          , Gg          , Ww          , Ww          , Gg          , Gg          , Gg          , Gg          , Gg          , Hh          , Hh          , Hh          , Mm          , Mm          , Mm          , Mm          
Mm          , Mm          , Mm          , Hh          , Hh          , Gs^Fp       , Gs^Fp       , Gg          , Gg          , Gg          , Gg          , Gg          , Ww          , Ai          , Ai          , Aa          , Aa          , Ch          , Gg          , Re          , Gg          , Gg^Ve       , Gg          , Gg^Vh       , Gg          , Gg^Ve       , Gg          , Re          , Ch          , Aa          , Aa          , Aa          , Gg          , Hh          , Gg          , Gg          , Ww          , Gg          , Gg          , Gg          , Gg          , Gg          , Gg          , Gg          , Hh          , Hh          , Mm          , Mm          , Mm          , Mm          
Mm          , Mm          , Mm          , Mm          , Hh          , Gs^Fp       , Gs^Fp       , Gs^Fp       , Gs^Fp       , Gg          , Gg          , Gg          , Ww          , Gg^Vh       , Aa          , Ai          , Ww          , Gg          , Re          , Re          , Gg          , Gg          , Gg          , Gg          , Gg          , Gg          , Ch          , Re          , Gg          , Aa          , Gg          , Gg          , Gg          , Hh          , Ww          , Ww          , Gg          , Gg          , Gg          , Gg          , Gg          , Gg          , Gg          , Gg          , Hh          , Hh          , Hh          , Hh          , Mm          , Mm          
Mm          , Mm          , Mm          , Mm          , Hh          , Hh          , Gs^Fp       , Gg          , Gs^Fp       , Gs^Fp       , Gg          , Ww          , Ww          , Hh          , Aa          , Aa          , Re          , Wwf         , Gg          , Ch          , Gg          , Gg          , Ww          , Ww          , Ww          , Gg          , Gg          , Re          , Ww          , Gg          , Ww          , Ww          , Ww          , Ww          , Hh          , Hh          , Gg          , Gg          , Gg          , Gg          , Gg          , Gg          , Gg          , Gg          , Hh          , Hh          , Hh          , Mm          , Mm          , Mm          
Mm          , Mm          , Mm          , Mm          , Hh          , Hh          , Hh          , Gg^Vh       , Ww          , Ww          , Ww          , Ww          , Hh          , Hh          , Re          , Re          , Gg          , Ww          , Ww          , Gg          , Ww          , Ww          , Wo          , Ww          , Wo          , Ww          , Ww          , Wwf         , Re          , Ww          , Gg          , Gs^Fp       , Gg^Ve       , Gg          , Hh          , Hh          , Gg          , Gg          , Gg          , Gg          , Gg          , Gg          , Gg          , Gg          , Gg          , Hh          , Hh          , Mm          , Mm          , Mm          
Ai          , Ai          , Ai          , Ww          , Ww          , Ww          , Ww          , Ww          , Ww          , Hh          , Hh          , Hh          , Hh          , Gg          , Re          , Gg          , Gg          , Gg          , Gg          , Ww          , Ww          , Wo          , Ww          , Wo          , Ww          , Ww          , Gg          , Gg          , Re          , Gg          , Gg          , Gs^Fp       , Gs^Fp       , Gs^Fp       , Hh          , Gg          , Gg          , Gg          , Gg          , Gg          , Gg          , Gg          , Gg          , Gg          , Gg          , Gg          , Hh          , Hh          , Mm          , Mm          
Ai          , Ai          , Ai          , Gg          , Gg          , Ww          , Ww          , Ww          , Ww          , Hh          , Hh          , Hh          , Hh          , Gg          , Re          , Gg          , Gg          , Gg          , Gg          , Gg          , Gg          , Ww          , Ai          , Wo          , Ai          , Ds          , Gg          , Re          , Re          , Gg          , Gg          , Gg          , Gg          , Gg          , Hh^Vhh      , Hh          , Gg          , Gg          , Gg          , Gg          , Gg          , Gg          , Gg          , Gg          , Hh          , Hh          , Hh          , Mm          , Mm          , Mm          
Mm          , Mm          , Gg          , Ww          , Ww          , Ww          , Ww          , Ww          , Ww          , Ww          , Hh          , Hh          , Gg          , Gg          , Hh          , Re          , Gg          , Gg          , Gg          , Gs^Fp       , Gg          , Gg          , Gg          , Ai          , Aa          , Ds          , Aa          , Gg          , Gg          , Re          , Re          , Gg          , Gg          , Gg          , Hh          , Hh          , Hh          , Gg          , Gg          , Gg          , Gg          , Gg          , Hh          , Hh          , Ha          , Ha          , Ha          , Mm          , Mm          , Mm          
Mm          , Mm          , Hh          , Ww          , Ww          , Ww          , Ww          , Ww          , Ai          , Ww          , Hh          , Gg          , Gg          , Hh          , Hh          , Re          , Re          , Gg          , Ww          , Gg          , Gg          , Gg          , Gg          , Aa          , Gg          , Gg          , Gg          , Gg          , Gg          , Gg          , Gg          , Re          , Gg          , Gg          , Hh          , Hh          , Hh          , Hh          , Mm          , Gg          , Gg          , Gg          , Hh          , Ha          , Mm          , Mm          , Mm          , Mm          , Mm          , Mm          
Mm          , Mm          , Mm          , Mm          , Mm          , Mm          , Ww          , Ww          , Mm          , Mm          , Mm          , Mm          , Hh          , Gg          , Gg          , Gg          , Re          , Gg          , Gg          , Gg          , Gg          , Gg          , Gg          , Gg          , Gg          , Gg          , Gg          , Gg          , Gg          , Gg          , Gg          , Re          , Re          , Gs^Fp       , Hh          , Hh          , Hh          , Mm          , Mm          , Mm          , Mm          , Mm          , Mm          , Mm          , Hh          , Hh          , Hh          , Hh          , Hh          , Hh          
Mm          , Mm          , Mm          , Mm          , Mm          , Mm          , Mm          , Mm          , Mm          , Mm          , Mm          , Mm          , Hh          , Gg          , Gg          , Gg          , Hh^Vhh      , Re          , Re          , Gg          , Gg          , Gg          , Gg          , Gg          , Gg          , Gg          , Gg          , Gg          , Gg          , Gs^Fp       , Gg          , Re          , Gs^Fp       , Re          , Gs^Fp       , Hh          , Gg          , Hh          , Gg          , Hh          , Gg          , Mm          , Mm          , Mm          , Mm          , Mm          , Mm          , Mm          , Mm          , Mm          
Mm          , Mm          , Mm          , Mm          , Mm          , Mm          , Mm          , Mm          , Mm          , Mm          , Mm          , Mm          , Hh          , Gg          , Hh          , Hh          , Hh          , Hh          , Re          , Gg          , Gg          , Gg          , Gg          , Gg          , Gg          , Gg          , Gs^Fp       , Gg          , Gs^Fp       , Gs^Fp       , Gg          , Re          , Gg^Ve       , Re          , Re          , Gg          , Gg          , Gg          , 1 Kh        , Gg          , Gg          , Mm          , Mm          , Mm          , Mm          , Mm          , Mm          , Mm          , Mm          , Mm          
Mm          , Mm          , Mm          , Mm          , Mm          , Mm          , Mm          , Mm          , Mm          , Mm          , Mm          , Mm          , Mm          , Hh          , Hh          , Mm          , Hh          , Hh          , Gg          , Re          , Gg          , Gg          , Gg          , Gg          , Hh          , Hh          , Hh          , Gg^Ve       , Gs^Fp       , Gs^Fp       , Re          , Re          , Gs^Fp       , Gs^Fp       , Gs^Fp       , Re          , Mm          , Mm          , Hh          , Hh          , Mm          , Mm          , Mm          , Mm          , Mm          , Mm          , Mm          , Mm          , Mm          , Mm          
Hh          , Hh          , Hh          , Mm          , Mm          , Mm          , Hh          , Mm          , Hh          , Mm          , Gg          , Mm          , Gg          , Hh          , Gg          , Mm          , Gg          , Hh          , Gg          , Re          , Gg          , Gg          , Gg          , Hh          , Hh          , Hh          , Hh          , Hh          , Gs^Fp       , Gs^Fp       , Re          , Gg          , Gg          , Gg          , Gg          , Re          , Hh          , Mm          , Mm          , Mm          , Mm          , Mm          , Mm          , Mm          , Mm          , Mm          , Mm          , Mm          , Mm          , Mm          
Hh          , Hh          , Hh          , Mm          , Mm          , Mm          , Hh          , Mm          , Hh          , Mm          , Gg          , Mm          , Gg          , Hh          , Gg          , Mm          , Gg          , Hh          , Gg          , Re          , Gg          , Gg          , Gg          , Hh          , Hh          , Hh          , Hh          , Hh          , Gs^Fp       , Gs^Fp       , Re          , Gg          , Gg          , Gg          , Gg          , Re          , Hh          , Mm          , Mm          , Mm          , Mm          , Mm          , Mm          , Mm          , Mm          , Mm          , Mm          , Mm          , Mm          , Mm          
