border_size=1
usage=map

       Wo,       Wo,       Wo,       Wo,       Ww,       Ww,       Ds,       Ds,       Ss,       Ss,       Ss,       Gs,       Gs,       Rd,       Rd,       Gg,       Ss,       Ss,       Ss,       Hh,    Gs^Fp,    Gs^Fp,       Gs,       Gs,       Gs,       Gs,       Ss,       Ss,       Ds,       Ds,       Ds,       Ds,       Ss,   Ss,       Ss,       Ss,    Gs^Fp,    Gs^Fp,       Gg,       Gg,    Gs^Fp,    Gs^Fp
       Wo,       Wo,       Wo,       Wo,       Ww,       Ww,       Ds,       Ds,       Ss,       Ss,       Ss,       Gs,       Gs,       Rd,       Rd,       Gg,       Ss,       Ss,       Ss,       Hh,    Gs^Fp,    Gs^Fp,       Gs,       Gs,       Gs,       Gs,       Ss,       Ss,       Ds,       Ds,       Ds,       Ds,       Ss,   Ss^Vhs,       Ss,       Ss,    Gs^Fp,    Gs^Fp,       Gg,       Gg,    Gs^Fp,    Gs^Fp
       Wo,       Wo,       Ww,       Ww,       Ds,       Ds,       Ds,       Ss,       Gg,   Ss^Vhs,       Gs,       Gs,       Ss,       Ss,       Rd,       Gg,       Gg,       Gg,       Ss,       Ds,       Ss,       Ss,       Ss,       Gs,       Ss,       Gs,       Gs,       Ss,       Gg,       Gg,       Gg,       Ds,       Ss,       Ss,       Ss,       Ss,       Ce,       Ce,       Ce,       Gg,    Gs^Fp,    Gs^Fp
       Ww,       Ww,       Ww,       Ds,       Ds,       Ds,       Ds,       Gg,       Ds,       Ds,       Ds,       Gs,       Ss,       Ss,       Rd,       Ss,       Ss,       Ss,       Ds,       Ds,       Gg,       Gg,       Ss,       Ss,       Ss,       Gs,       Ss,       Gg,       Gg,       Gg,       Ss,       Gg,       Ss,       Ss,       Ss,       Gs,       Ce,     3 Ke,       Ce,       Gg,       Hh,       Hh
       Wo,       Wo,       Ww,       Ww,       Ww,       Ww,       Ds,       Ss,       Ss,       Ds,       Ds,       Ds,       Ds,       Ss,     5 Kh,       Ss,       Ss,       Re,       Re,       Re,       Gs,       Gg,       Ss,   Ss^Vhs,       Ss,       Re,       Re,       Ss,       Ss,       Ss,       Ss,       Ds,       Ds,       Ss,       Gs,       Gs,       Gs,       Ce,       Gs,       Hh,       Hh,       Hh
       Wo,       Wo,       Ww,       Ww,       Ww,       Ww,       Ww,       Ss,       Ss,       Ss,       Ds,       Ds,       Re,       Re,       Re,       Rd,       Rd,       Ds,       Ds,       Ds,       Gs,       Gs,       Gs,       Ss,       Wo,       Ww,       Ds,       Ss,       Ss,       Ss,       Ds,       Ds,       Ds,       Re,       Gg,       Gs,       Gs,       Gs,       Re,       Re,       Re,       Re
       Wo,       Wo,       Wo,       Wo,       Wo,       Ww,       Ds,       Ss,       Ds,       Ss,       Ss,       Gs,       Re,    Gs^Fp,    Gs^Fp,       Re,       Rd,       Ds,       Ds,       Ds,       Gs,       Gs,       Ww,       Wo,       Wo,       Ww,       Ww,       Ds,       Ss,       Ss,       Ss,       Re,       Re,       Re,       Gg,       Gg,       Gg,       Gs,       Mm,       Re,       Re,       Re
       Wo,       Wo,       Wo,       Ww,       Wo,       Ww,       Ds,       Ds,       Ds,       Ds,       Gs,       Re,       Ss,    Gs^Fp,       Ss,    Gs^Fp,       Rd,       Ds,       Ss,       Ss,       Ss,       Gs,       Ds,       Ww,       Ww,       Ww,       Ds,       Ds,       Ss,       Ss,       Wo,       Ww,    Gs^Fp,    Gs^Fp,       Gg,       Gg,       Gg,       Hh,       Mm,       Mm,       Re,       Re
       Wo,       Wo,       Ww,       Ww,       Ww,       Ww,       Ds,       Ds,       Gg,       Re,       Re,       Re,      Chw,       Ss,       Re,       Rd,       Ss,   Ss^Vhs,       Ss,       Ss,       Ds,       Ds,       Ss,       Ww,       Wo,       Ww,       Ww,       Ww,       Ww,       Wo,       Ww,       Ww,    Gs^Fp,    Gg^Ve,    Gs^Fp,       Gg,       Hh,       Hh,       Mm,       Mm,       Mm,       Mm
       Wo,       Wo,       Ww,       Ww,       Ww,       Ww,       Ds,       Ds,       Gg,       Gg,       Ds,      Chw,     2 Kh,      Chw,       Gs,       Rd,       Ss,       Re,       Re,       Ds,       Ww,       Ss,       Wo,       Wo,       Wo,       Wo,       Ww,       Ww,       Ww,       Ww,       Ww,       Ww,       Ww,    Gs^Fp,       Gg,       Hh,       Mm,       Mm,       Mm,       Mm,       Ds,       Ds
       Wo,       Wo,       Ww,       Wo,       Ww,       Ww,       Ww,       Ds,       Gg,       Gg,       Ww,      Chw,      Chw,      Chw,       Gs,       Rd,       Ss,       Gg,       Ww,       Ww,       Ww,       Ww,       Ww,       Wo,       Ww,       Ww,       Ww,       Re,    Gs^Fp,    Gs^Fp,       Ss,       Ww,      Wwf,      Wwf,       Ww,       Hh,       Hh,       Mm,       Ww,       Ww,       Ww,       Ww
       Wo,       Wo,       Ww,       Ww,       Wo,       Ww,       Ww,       Ww,       Ww,       Ww,    Ww^Vm,       Ww,       Ww,       Ds,       Ds,       Rd,      Wwf,       Ww,       Ww,       Ww,       Ww,       Ww,       Wo,       Ww,       Ww,       Ww,       Re,       Re,       Ss,       Ss,    Gs^Fp,    Gs^Fp,       Ww,       Ww,       Ww,       Hh,       Hh,       Ww,       Ww,       Ww,       Ww,       Ww
       Wo,       Wo,       Ww,       Wo,       Wo,       Wo,       Ww,       Ww,       Ww,       Ww,       Ww,       Ww,       Ww,       Ww,       Ww,      Wwf,      Wwf,      Wwf,       Ww,       Ss,       Ss,       Wo,       Wo,       Wo,       Ww,       Ww,       Re,       Ss,       Ss,       Ss,    Gs^Fp,       Gs,       Ww,       Ww,       Ww,       Hh,       Hh,       Ww,       Ww,       Ww,       Ds,       Ds
       Wo,       Wo,       Wo,       Wo,       Wo,       Wo,       Ww,       Ww,       Ww,       Ww,       Ww,       Ww,       Ww,       Ww,       Ww,       Ww,      Wwf,      Wwf,       Gs,       Ss,       Gg,       Ww,       Ww,       Ww,       Ww,       Re,       Ss,       Ss,       Ss,       Ss,       Ss,       Gs,       Ww,       Ww,       Ww,       Hh,       Hh,       Ww,       Ww,       Ds,       Re,       Re
       Wo,       Wo,       Wo,       Wo,       Wo,       Wo,       Ww,       Ww,       Ds,    Gs^Fp,    Gs^Fp,       Gg,       Gg,       Ww,       Ww,       Ww,       Gs,       Rd,       Rd,       Ss,       Gg,       Gg,       Ww,       Ww,   Ss^Vhs,       Ss,       Ss,       Ss,       Re,       Ss,       Gs,       Gs,       Re,       Ww,       Ww,       Ww,       Ww,       Ww,       Ww,       Re,       Re,       Re
       Wo,       Wo,       Wo,       Wo,       Wo,       Wo,       Ww,       Ww,       Ds,    Gs^Fp,    Gs^Fp,       Gg,       Gg,    Gs^Fp,       Re,       Gs,       Gs,       Gs,       Rd,       Gg,       Gg,       Gg,       Gs,       Gs,       Gg,       Ss,       Gg,       Re,       Re,       Re,       Ss,       Ss,       Re,       Re,       Ww,       Ww,       Ww,       Ww,       Re,       Re,       Re,       Re
       Wo,       Wo,       Wo,       Wo,       Wo,       Wo,       Ww,       Ww,       Ds,       Ss,    Gs^Fp,       Gg,       Gg,       Re,       Re,       Gs,       Gs,   Gs^Vht,       Rd,       Gg,       Gg,       Gg,       Gs,       Gs,       Gg,       Gg,       Gg,       Re,       Re,       Re,       Ss,       Ss,       Re,       Ww,    Ww^Vm,       Ww,       Gs,       Gs,       Gs,       Gs,       Re,       Re
       Wo,       Wo,       Wo,       Ww,       Wo,       Wo,       Ww,       Ww,       Wo,       Ss,    Gs^Fp,    Gs^Fp,       Ds,       Ds,       Ds,       Ds,       Ds,       Gs,       Rd,       Ds,       Ds,       Ds,       Gs,       Gs,       Gg,       Ss,       Gg,       Gg,       Re,       Ss,       Ss,       Re,       Ss,       Ww,       Ww,       Ww,       Gs,       Gs,       Gs,       Gs,       Re,       Re
       Wo,       Wo,       Ww,       Ww,       Ww,       Ww,       Ww,       Ww,       Wo,       Ds,       Ds,       Ds,       Ds,       Ds,       Ds,       Ss,       Ss,       Ds,       Ds,       Rd,       Ds,       Ds,       Ds,       Gs,       Gg,       Ss,       Ss,       Ss,       Ds,       Ds,       Ss,       Ss,       Ww,       Ww,       Wo,       Wo,       Ww,       Gs,       Gs,       Gs,       Ds,       Ds
       Wo,       Wo,       Ww,       Ww,       Ww,       Ww,       Ds,       Ds,       Ds,       Ds,       Re,       Ss,       Ss,       Ss,       Ss,       Ss,       Ss,       Ds,       Ds,       Rd,       Ss,       Ss,       Ds,       Ds,       Gg,       Gg,       Ss,       Ss,       Ds,       Ds,       Ds,       Ss,       Ww,       Wo,       Wo,       Wo,       Ww,       Ww,       Ds,       Ds,       Ds,       Ds
       Wo,       Wo,       Ww,       Ds,       Ds,       Ds,       Ds,       Ds,       Ds,       Ds,       Re,       Re,       Ss,       Ss,       Ss,       Ss,       Ss,       Ss,       Ss,       Rd,       Ss,       Ss,       Ss,       Gg,       Gg,       Gg,       Ss,       Ss,       Ds,       Ds,       Ds,       Ww,       Ww,       Wo,       Ww,       Ww,       Ww,       Ds,       Ss,       Ds,       Ss,       Ss
       Wo,       Wo,       Ww,       Ds,       Ww,       Ww,       Ww,       Ww,       Ww,       Ww,       Ww,       Ww,       Re,       Ss,       Ss,       Ss,       Ss,       Ss,       Rd,       Rd,       Ss,       Gg,       Ss,       Ss,       Gg,       Gg,       Ww,       Ss,       Ss,       Ww,       Wo,       Wo,       Ww,    Gs^Fp,       Ss,       Ww,       Ds,       Ds,       Ss,       Ss,       Ss,       Ss
       Wo,       Wo,       Ww,       Ww,       Ww,       Ww,       Ww,       Ww,       Ww,       Ww,       Ww,       Ww,       Ww,       Re,       Ds,       Ds,       Ds,       Ds,       Rd,    Gs^Fp,    Gs^Fp,    Gs^Fp,       Ss,       Ss,       Gg,       Ww,       Ww,       Wo,       Wo,       Wo,       Wo,       Ww,       Ww,       Ss,       Ss,       Ss,       Ss,       Gs,       Ss,       Ss,       Ss,       Ss
       Wo,       Wo,       Ww,       Ww,       Gs,       Gs,       Gs,       Gs,       Gs,       Ww,      Chw,      Chw,      Chw,       Ww,       Gg,       Gg,       Gg,       Gg,    Gg^Vh,       Rd,    Gs^Fp,       Ds,       Ss,       Ss,   Ss^Vhs,       Gg,       Ww,       Ww,       Ww,       Ww,       Ww,       Ww,       Ds,       Ss,       Ds,       Ss,       Ds,       Gs,       Ss,   Ss^Vhs,       Ss,       Ss
       Wo,       Wo,       Ww,       Ww,       Ww,       Gs,       Gs,       Gs,     1 Kh,       Gg,      Chw,     6 Kh,      Chw,      Wwf,       Gg,       Gg,       Gg,       Gg,       Rd,       Rd,       Ds,       Gg,       Ss,       Ss,       Ss,       Ss,       Ss,       Ww,       Gs,       Gs,       Gs,       Gs,       Ds,       Ds,       Ds,       Ds,       Ds,       Gs,       Gs,       Ss,       Gs,       Gs
       Wo,       Wo,       Wo,       Wo,       Ww,       Gs,       Gs,    Gg^Vh,       Gg,       Gg,       Ww,      Chw,       Ww,       Ww,       Gg,       Gg,       Rd,       Rd,       Ss,       Ss,       Ss,       Gg,       Gg,       Ss,    Gs^Fp,       Ss,       Ss,       Gs,       Gs,       Gs,    Gs^Fp,    Gs^Fp,    Gs^Fp,       Ds,       Gg,       Gg,       Gg,       Gs,       Ss,       Gs,       Gs,       Gs
       Wo,       Wo,       Ww,       Ww,       Ww,    Gs^Fp,       Ss,       Ss,       Ss,       Gg,       Gg,       Ww,       Gs,       Gs,       Ss,       Ss,       Rd,       Ss,       Ss,       Ss,       Ss,       Gg,       Gg,    Gs^Fp,    Gs^Fp,       Gg,       Gg,       Re,       Re,       Re,    Gs^Fp,    Gg^Ve,    Gs^Fp,       Ds,       Gg,       Gg,       Ss,       Ss,       Ss,       Gs,       Ds,       Ds
       Wo,       Wo,       Ww,       Ww,       Ww,    Gs^Fp,       Ss,       Ss,       Ss,       Gg,       Gg,       Gg,       Gs,       Gs,       Ss,       Ss,       Rd,       Ss,       Ss,       Ss,       Gg,       Gg,       Ss,    Gs^Fp,    Gs^Fp,       Gg,       Gg,       Re,       Re,       Re,    Gs^Fp,    Gs^Fp,       Gs,       Gs,       Ss,       Gg,       Ss,   Ss^Vhs,       Ss,       Ds,       Ds,       Ds
       Wo,       Wo,       Ww,       Ww,       Ww,       Re,       Ss,       Ss,       Gg,       Gg,       Ds,       Ds,       Ds,       Gs,       Gs,       Gs,       Rd,       Ss,       Ss,       Ss,       Gg,       Gg,       Ss,       Ds,       Ss,       Ds,       Ds,       Re,       Gs,       Gs,       Gs,       Gs,       Ss,       Ss,       Ss,       Ss,       Ss,       Ss,       Ss,       Ds,       Ds,       Ds
       Wo,       Wo,       Wo,       Wo,       Ww,       Re,       Ss,       Ss,       Gs,       Gg,       Ds,       Ds,       Ds,    Gs^Fp,       Gs,       Gs,       Rd,       Ss,       Gg,       Ss,       Ds,       Ds,       Ds,       Ss,       Ss,       Ds,       Ds,       Ds,       Gs,       Gs,       Gs,       Gs,       Ss,       Ss,       Ss,       Ss,       Gg,       Gg,       Gg,       Ds,       Ds,       Ds
       Wo,       Wo,       Wo,       Wo,       Ww,       Re,       Gs,       Gs,       Gs,       Gs,       Ds,       Ds,    Gs^Fp,    Gs^Fp,       Gs,       Gs,       Rd,       Ss,       Ss,       Ss,       Ds,       Ds,       Ds,       Ss,       Ss,       Ds,       Ds,       Ds,       Ds,       Gs,       Gs,       Gs,       Ss,       Ss,       Ss,       Ss,       Ss,       Gg,       Gg,       Ds,       Ds,       Ds
       Wo,       Wo,       Wo,       Wo,       Ww,       Re,       Gs,       Gs,       Gs,       Gs,       Ds,       Ds,    Gs^Fp,    Gs^Fp,       Gs,       Gs,       Rd,       Ss,       Ss,       Ss,       Ds,       Ds,       Ds,       Ss,       Ss,       Ds,       Ds,       Ds,       Ds,       Gs,       Gs,       Gs,       Ss,       Ss,       Ss,       Ss,       Ss,       Gg,       Gg,       Ds,       Ds,       Ds
